Country,Year,NumDisaster,NumKilled,NumInjured,NumAffected,NumHomeless,AffectedPop,TotalDamUSD,Continent
Afghanistan,2000,6,594,0,2582228,0,2582228,50,Asia
Afghanistan,2001,6,485,20,204425,250,204695,10,Asia
Afghanistan,2002,16,4083,1391,302279,10000,313670,0,Asia
Afghanistan,2003,9,137,4,500,4250,4754,0,Asia
Afghanistan,2004,3,18,40,2800,2700,5540,0,Asia
Afghanistan,2005,14,582,44,37901,6775,44720,5050,Asia
Afghanistan,2006,13,382,185,2225515,8210,2233910,0,Asia
Afghanistan,2007,7,296,20,26755,3480,30255,0,Asia
Afghanistan,2008,4,1334,182,452602,180,452964,0,Asia
Afghanistan,2009,5,101,86,62521,3250,65857,20000,Asia
Afghanistan,2010,5,350,200,45000,1000,46200,0,Asia
Afghanistan,2011,4,83,115,1753000,9700,1762815,142000,Asia
Afghanistan,2012,11,378,427,48394,2680,51501,0,Asia
Afghanistan,2013,3,48,141,14500,0,14641,0,Asia
Albania,2002,3,7,0,192110,0,192110,17500,Europe
Albania,2004,2,3,0,2500,0,2500,173,Europe
Albania,2005,2,5,0,400500,0,400500,0,Europe
Albania,2007,2,0,0,150,75,225,0,Europe
Albania,2009,2,0,0,6600,150,6750,0,Europe
Albania,2010,1,0,0,14000,0,14000,0,Europe
Albania,2012,1,5,0,230000,0,230000,0,Europe
Algeria,2000,5,48,15,100,100,215,0,Africa
Algeria,2001,1,921,423,45000,0,45423,300000,Africa
Algeria,2002,3,48,20,2285,0,2305,1500,Africa
Algeria,2003,7,2369,10511,0,200000,210511,5000000,Africa
Algeria,2004,4,22,335,27545,0,27880,0,Africa
Algeria,2005,4,34,5,70,1750,1825,7256,Africa
Algeria,2006,2,5,9,60160,150,60319,1200,Africa
Algeria,2007,7,90,5,1300,0,1305,43061,Africa
Algeria,2008,1,93,50,59000,0,59050,348000,Africa
Algeria,2009,2,48,48,0,2500,2548,0,Africa
Algeria,2010,1,2,43,0,0,43,0,Africa
Algeria,2011,1,10,43,750,0,793,779000,Africa
Algeria,2012,2,69,101,0,0,101,0,Africa
American Samoa,2003,1,6,3,0,0,3,50000,Oceania
American Samoa,2004,1,0,60,20000,3000,23060,150000,Oceania
American Samoa,2005,1,0,0,0,0,0,0,Oceania
American Samoa,2009,1,34,0,2500,0,2500,0,Oceania
Angola,2000,6,77,11,70117,9000,79128,10000,Africa
Angola,2001,5,154,5,40348,0,40353,0,Africa
Angola,2002,1,8,0,0,0,0,0,Africa
Angola,2003,2,15,0,0,825,825,0,Africa
Angola,2004,5,357,0,357045,1700,358745,0,Africa
Angola,2005,1,0,0,0,10000,10000,0,Africa
Angola,2006,3,2422,0,57570,225,57795,0,Africa
Angola,2007,4,620,0,58343,6000,64343,0,Africa
Angola,2008,3,370,0,98837,0,98837,0,Africa
Angola,2009,5,178,0,245938,5065,251003,0,Africa
Angola,2010,3,25,31,110875,78875,189781,0,Africa
Angola,2011,4,130,0,90584,100,90684,0,Africa
Angola,2012,1,0,0,1833900,0,1833900,0,Africa
Angola,2013,1,9,0,1000,0,1000,0,Africa
Antigua and Barbuda,2008,1,0,0,25800,0,25800,0,Americas
Antigua and Barbuda,2010,1,0,0,5000,0,5000,12600,Americas
Argentina,2000,8,37,40,30300,8230,38570,300000,Americas
Argentina,2001,7,35,150,254800,2000,256950,765000,Americas
Argentina,2002,5,11,27,17700,200,17927,0,Americas
Argentina,2003,4,39,0,143900,20000,163900,1148210,Americas
Argentina,2004,3,10,7,6300,0,6307,0,Americas
Argentina,2005,1,11,52,0,200,252,0,Americas
Argentina,2006,1,0,0,4500,0,4500,0,Americas
Argentina,2007,3,19,0,130000,5000,135000,40000,Americas
Argentina,2008,2,0,0,85000,0,85000,0,Americas
Argentina,2009,6,29,24,67494,0,67518,15000,Americas
Argentina,2010,1,42,0,0,0,0,0,Americas
Argentina,2011,1,0,0,0,0,0,0,Americas
Argentina,2012,3,25,30,17500,2000,19530,10000,Americas
Argentina,2013,1,54,0,350000,0,350000,503000,Americas
Armenia,2000,1,0,0,297000,0,297000,100000,Asia
Armenia,2004,1,1,0,0,0,0,0,Asia
Australia,2000,6,1,0,2150,0,2150,535000,Oceania
Australia,2001,9,6,58,8550,0,8608,321600,Oceania
Australia,2002,6,2,4,126,249,379,2050000,Oceania
Australia,2003,10,6,150,5010,30,5190,470000,Oceania
Australia,2004,7,6,0,4265,0,4265,112500,Oceania
Australia,2005,4,20,20,4400,0,4420,137000,Oceania
Australia,2006,8,4,30,3100,7141,10271,1282354,Oceania
Australia,2007,2,11,0,5730,90,5820,1400000,Oceania
Australia,2008,5,8,0,20400,0,20400,2515000,Oceania
Australia,2009,6,535,2500,34054,0,36554,1510000,Oceania
Australia,2010,8,36,0,186000,0,186000,10129000,Oceania
Australia,2011,3,1,0,7637,0,7637,2554000,Oceania
Australia,2012,2,4,0,16000,0,16000,588000,Oceania
Australia,2013,1,6,0,7500,0,7500,2000000,Oceania
Austria,2000,2,13,0,0,0,0,20000,Europe
Austria,2002,3,12,0,60300,0,60300,2405000,Europe
Austria,2003,1,345,0,0,0,0,280000,Europe
Austria,2005,3,4,0,900,0,900,700000,Europe
Austria,2006,1,0,0,516,0,516,0,Europe
Austria,2007,2,5,0,0,0,0,400000,Europe
Austria,2008,1,4,0,0,0,0,500000,Europe
Austria,2009,4,3,0,0,0,0,700000,Europe
Austria,2012,1,5,0,0,0,0,0,Europe
Austria,2013,1,2,0,200,0,200,0,Europe
Azerbaijan,2000,3,42,600,2694,0,3294,110000,Asia
Azerbaijan,2003,1,0,0,30000,1500,31500,55000,Asia
Azerbaijan,2009,1,0,0,5000,0,5000,0,Asia
Azerbaijan,2010,1,3,0,70000,0,70000,0,Asia
Azerbaijan,2012,3,5,50,15500,6949,22499,0,Asia
Bahamas,2001,1,0,0,0,0,0,300000,Americas
Bahamas,2004,3,12,0,9000,0,9000,1550000,Americas
Bahamas,2005,1,1,0,1500,0,1500,0,Americas
Bahamas,2007,1,1,0,7000,0,7000,0,Americas
Bahamas,2008,2,0,0,3000,0,3000,0,Americas
Bahamas,2011,1,0,0,10000,0,10000,40000,Americas
Bahamas,2012,1,1,0,0,0,0,0,Americas
Bangladesh,2000,15,222,659,2766852,85500,2853011,500000,Asia
Bangladesh,2001,7,253,4750,726000,0,730750,0,Asia
Bangladesh,2002,7,928,400,1699904,1000,1701304,0,Asia
Bangladesh,2003,8,529,645,552500,0,553145,0,Asia
Bangladesh,2004,10,1034,3350,36872604,14000,36889954,2700000,Asia
Bangladesh,2005,12,332,2106,1163000,21500,1186606,0,Asia
Bangladesh,2006,7,154,1264,226260,2400,229924,0,Asia
Bangladesh,2007,7,5721,55342,23159549,225,23215116,2414000,Asia
Bangladesh,2008,5,68,452,600000,35638,636090,0,Asia
Bangladesh,2009,6,348,7187,4497363,0,4504550,270000,Asia
Bangladesh,2010,6,107,350,887040,0,887390,0,Asia
Bangladesh,2011,5,102,121,1672559,0,1672680,0,Asia
Bangladesh,2012,5,336,304,5602850,55000,5658154,0,Asia
Bangladesh,2013,3,50,388,1327463,0,1327851,0,Asia
Barbados,2002,1,0,0,0,2000,2000,200,Americas
Barbados,2004,1,1,0,0,880,880,5000,Americas
Barbados,2007,1,0,1,0,0,1,0,Americas
Barbados,2010,2,0,0,2500,0,2500,0,Americas
Belarus,2000,1,0,0,0,0,0,30300,Europe
Belarus,2005,1,5,1820,0,0,1820,0,Europe
Belarus,2007,1,0,0,0,0,0,10000,Europe
Belarus,2012,1,0,30,100,0,130,0,Europe
Belarus,2013,1,4,1325,10000,0,11325,0,Europe
Belgium,2002,5,7,0,2400,0,2400,5000,Europe
Belgium,2003,2,1175,0,0,0,0,0,Europe
Belgium,2005,3,2,0,210,0,210,0,Europe
Belgium,2006,1,940,0,0,0,0,0,Europe
Belgium,2007,1,2,2,0,0,2,450000,Europe
Belgium,2008,2,1,0,0,0,0,0,Europe
Belgium,2010,3,4,0,690,0,690,398146,Europe
Belgium,2011,2,5,71,0,0,71,99000,Europe
Belgium,2012,1,3,0,0,0,0,0,Europe
Belize,2000,1,14,570,62000,0,62570,277460,Americas
Belize,2001,2,30,0,20000,0,20000,250000,Americas
Belize,2005,2,3,0,0,0,0,0,Americas
Belize,2007,1,0,0,20000,0,20000,14847,Americas
Belize,2008,2,8,0,48000,0,48000,9697,Americas
Belize,2010,1,0,0,0,0,0,0,Americas
Benin,2000,3,351,0,7762,0,7762,0,Africa
Benin,2001,3,378,0,9760,0,9760,0,Africa
Benin,2002,1,50,0,452,0,452,0,Africa
Benin,2003,1,3,0,265,0,265,0,Africa
Benin,2005,1,4,0,206,0,206,0,Africa
Benin,2007,1,10,0,10000,884,10884,0,Africa
Benin,2008,4,48,0,159223,0,159223,0,Africa
Benin,2009,3,10,0,120457,0,120457,0,Africa
Benin,2010,4,71,1000,681037,150000,832037,0,Africa
Benin,2011,1,0,0,5840,0,5840,0,Africa
Benin,2012,1,4,0,55000,0,55000,0,Africa
Bermuda,2003,1,4,0,0,0,0,300000,Americas
Bhutan,2000,1,200,0,0,1000,1000,0,Asia
Bhutan,2004,1,0,0,0,0,0,0,Asia
Bhutan,2009,2,23,12,0,0,12,0,Asia
Bhutan,2011,1,1,16,20000,0,20016,0,Asia
Bolivia,2000,4,36,10,52277,0,52287,0,Americas
Bolivia,2001,2,50,5,357250,0,357255,121000,Americas
Bolivia,2002,3,96,146,17085,0,17231,100000,Americas
Bolivia,2003,4,143,40,48190,10300,58530,1000,Americas
Bolivia,2004,1,0,0,55000,0,55000,0,Americas
Bolivia,2005,1,0,0,3000,0,3000,0,Americas
Bolivia,2006,2,25,50,126550,0,126600,35000,Americas
Bolivia,2007,4,116,0,824723,0,824723,590000,Americas
Bolivia,2008,4,27,0,41357,0,41357,0,Americas
Bolivia,2009,1,0,0,63000,0,63000,0,Americas
Bolivia,2010,5,59,0,315596,300,315896,100000,Americas
Bolivia,2011,2,52,0,92825,0,92825,20000,Americas
Bolivia,2012,1,13,0,69085,0,69085,0,Americas
Bolivia,2013,1,25,0,145000,0,145000,0,Americas
Bosnia-Hercegovenia,2000,3,6,3,800,0,803,158000,Europe
Bosnia-Hercegovenia,2001,1,0,0,9000,0,9000,0,Europe
Bosnia-Hercegovenia,2003,2,0,0,62575,0,62575,140000,Europe
Bosnia-Hercegovenia,2004,2,0,0,278000,0,278000,0,Europe
Bosnia-Hercegovenia,2005,2,4,0,3100,0,3100,0,Europe
Bosnia-Hercegovenia,2007,1,0,0,0,0,0,0,Europe
Bosnia-Hercegovenia,2009,3,1,0,13730,0,13730,0,Europe
Bosnia-Hercegovenia,2010,3,5,0,34910,0,34910,87000,Europe
Bosnia-Hercegovenia,2012,1,4,0,10347,0,10347,0,Europe
Botswana,2000,1,3,0,106776,32000,138776,5000,Africa
Botswana,2004,1,0,0,4960,0,4960,0,Africa
Botswana,2005,1,0,0,0,0,0,0,Africa
Botswana,2006,1,470,0,22264,0,22264,0,Africa
Botswana,2008,1,2,0,15,0,15,0,Africa
Botswana,2009,3,0,0,5056,0,5056,0,Africa
Botswana,2011,1,0,0,0,0,0,0,Africa
Botswana,2013,1,0,0,4210,0,4210,0,Africa
Brazil,2000,6,115,0,17000,213000,230000,75000,Americas
Brazil,2001,5,98,196,1001750,12500,1014446,45000,Americas
Brazil,2002,6,161,0,319730,3000,322730,11000,Americas
Brazil,2003,5,255,571,18000,187410,205981,303000,Americas
Brazil,2004,5,39,114,153000,2200,155314,2000370,Americas
Brazil,2005,4,49,4,31000,10340,41344,0,Americas
Brazil,2006,2,20,0,116000,0,116000,0,Americas
Brazil,2007,6,70,86,1211552,0,1211638,125000,Americas
Brazil,2008,6,326,27,1951713,3035,1954775,1013000,Americas
Brazil,2009,10,203,64,1994507,2950,1997521,745000,Americas
Brazil,2010,6,395,403,1235688,13000,1249091,802000,Americas
Brazil,2011,8,978,0,1185600,30000,1215600,1000000,Americas
Brazil,2012,2,0,0,210000,0,210000,1631000,Americas
Brazil,2013,2,34,44,200000,0,200044,0,Americas
Bulgaria,2000,4,14,17,0,150,167,17650,Europe
Bulgaria,2001,2,2,0,0,0,0,0,Europe
Bulgaria,2002,1,1,0,0,0,0,1000,Europe
Bulgaria,2005,7,57,20,12200,0,12220,457000,Europe
Bulgaria,2006,3,0,2,525,0,527,0,Europe
Bulgaria,2007,6,17,69,1060,0,1129,2454,Europe
Bulgaria,2008,1,10,0,0,0,0,0,Europe
Bulgaria,2010,2,3,0,90,0,90,0,Europe
Bulgaria,2012,4,38,70,38090,0,38160,4400,Europe
Burkina Faso,2001,4,2978,0,20820,0,20820,0,Africa
Burkina Faso,2003,2,1058,0,7146,12120,19266,0,Africa
Burkina Faso,2004,2,527,0,2783,0,2783,0,Africa
Burkina Faso,2005,1,9,0,606,0,606,0,Africa
Burkina Faso,2006,3,784,0,23012,10000,33012,0,Africa
Burkina Faso,2007,2,1542,73,113735,28000,141808,0,Africa
Burkina Faso,2008,4,556,18,53560,4292,57870,0,Africa
Burkina Faso,2009,3,398,1000,153392,0,154392,150000,Africa
Burkina Faso,2010,2,857,0,139322,0,139322,176,Africa
Burkina Faso,2011,1,0,0,2850000,0,2850000,0,Africa
Burkina Faso,2012,1,18,0,0,21000,21000,0,Africa
Burundi,2000,4,308,100,730591,500,731191,0,Africa
Burundi,2002,5,87,0,10163,0,10163,0,Africa
Burundi,2003,2,6,0,230,0,230,0,Africa
Burundi,2004,4,3,0,0,25620,25620,0,Africa
Burundi,2005,2,120,0,2150000,5000,2155000,0,Africa
Burundi,2006,7,22,5,7000,9305,16310,0,Africa
Burundi,2007,2,5,6,2695,23000,25701,0,Africa
Burundi,2008,3,9,5,85770,0,85775,0,Africa
Burundi,2009,2,0,0,188000,0,188000,0,Africa
Burundi,2010,4,9,0,1990,1500,3490,0,Africa
Burundi,2011,3,24,50,1285,0,1335,0,Africa
Cambodia,2000,1,347,53,3448000,0,3448053,160000,Asia
Cambodia,2001,2,56,0,1969182,0,1969182,15000,Asia
Cambodia,2002,2,29,0,2120000,0,2120000,38100,Asia
Cambodia,2004,2,7,0,0,0,0,0,Asia
Cambodia,2005,2,16,0,600000,0,600000,0,Asia
Cambodia,2006,3,5,0,42368,0,42368,0,Asia
Cambodia,2007,2,184,0,36000,0,36000,1000,Asia
Cambodia,2009,2,19,91,178000,0,178091,0,Asia
Cambodia,2010,1,8,0,0,0,0,70000,Asia
Cambodia,2011,1,247,23,1640000,0,1640023,521000,Asia
Cambodia,2012,1,14,0,71500,0,71500,0,Asia
Cameroon,2000,2,25,0,565,0,565,0,Africa
Cameroon,2001,4,61,0,542,1500,2042,0,Africa
Cameroon,2003,1,20,0,0,100,100,0,Africa
Cameroon,2004,1,46,0,2924,0,2924,0,Africa
Cameroon,2005,3,44,0,1400,0,1400,0,Africa
Cameroon,2006,1,8,0,71,0,71,0,Africa
Cameroon,2007,1,8,17,0,10279,10296,0,Africa
Cameroon,2008,1,9,0,24000,1000,25000,0,Africa
Cameroon,2009,1,109,1456,0,0,1456,0,Africa
Cameroon,2010,2,235,95,2849,3000,5944,0,Africa
Cameroon,2011,1,639,0,16706,0,16706,0,Africa
Cameroon,2012,2,25,0,20000,31980,51980,0,Africa
Canada,2000,1,11,140,0,700,840,13000,Americas
Canada,2001,3,12,0,1599,30,1629,0,Americas
Canada,2002,4,45,0,947,0,947,0,Americas
Canada,2003,7,7,0,2670,0,2670,690000,Americas
Canada,2004,4,0,0,1000,0,1000,300000,Americas
Canada,2005,5,4,0,5900,0,5900,357000,Americas
Canada,2006,5,1,0,3900,0,3900,0,Americas
Canada,2007,3,6,0,500,0,500,0,Americas
Canada,2008,2,0,0,2400,0,2400,0,Americas
Canada,2009,3,2,3,200,0,203,500000,Americas
Canada,2010,1,0,0,0,0,0,0,Americas
Canada,2011,4,8,20,2000,7000,9020,2300000,Americas
Canada,2012,3,0,0,1500,0,1500,1084000,Americas
Canada,2013,1,3,0,100000,0,100000,3000000,Americas
Canary Is,2001,1,7,0,300,0,300,0,Europe
Canary Is,2002,1,16,30,400,0,430,79923,Europe
Canary Is,2004,1,13,113,0,0,113,0,Europe
Canary Is,2005,1,19,0,0,0,0,375000,Europe
Canary Is,2007,1,0,0,300,105,405,0,Europe
Central African Rep,2000,3,448,0,2572,0,2572,0,Africa
Central African Rep,2001,2,346,0,1473,3000,4473,0,Africa
Central African Rep,2002,2,7,0,727,750,1477,0,Africa
Central African Rep,2003,2,23,0,379,240,619,0,Africa
Central African Rep,2004,1,3,0,0,12698,12698,0,Africa
Central African Rep,2005,1,1,7,0,23798,23805,0,Africa
Central African Rep,2007,1,1,0,6000,1812,7812,0,Africa
Central African Rep,2008,1,0,0,0,795,795,0,Africa
Central African Rep,2009,3,4,0,9137,14835,23972,0,Africa
Central African Rep,2010,1,3,0,1585,0,1585,0,Africa
Central African Rep,2011,3,17,1,4937,0,4938,0,Africa
Central African Rep,2012,2,0,23,0,3870,3893,0,Africa
Central African Rep,2013,1,0,63,0,0,63,0,Africa
Chad,2000,2,1209,0,9673,0,9673,0,Africa
Chad,2001,3,213,0,979207,0,979207,1000,Africa
Chad,2003,1,11,0,131,0,131,0,Africa
Chad,2004,3,144,0,3567,0,3567,0,Africa
Chad,2005,1,115,0,6000,0,6000,0,Africa
Chad,2006,2,72,0,216,0,216,0,Africa
Chad,2007,3,29,145,173000,0,173145,0,Africa
Chad,2008,3,22,0,9755,6450,16205,0,Africa
Chad,2009,4,108,0,2407991,5795,2413786,0,Africa
Chad,2010,4,263,0,149898,0,149898,0,Africa
Chad,2011,2,557,0,18123,0,18123,0,Africa
Chad,2012,4,108,0,2215339,0,2215339,10000,Africa
Chile,2000,3,16,0,171266,10401,181667,40000,Americas
Chile,2001,4,6,0,14245,714,14959,8900,Americas
Chile,2002,5,19,0,255642,0,255642,280000,Americas
Chile,2003,1,0,0,0,285,285,0,Americas
Chile,2004,2,3,0,9000,0,9000,0,Americas
Chile,2005,4,61,182,28375,548,29105,5000,Americas
Chile,2006,1,18,0,95862,0,95862,0,Americas
Chile,2007,3,18,155,25000,0,25155,100000,Americas
Chile,2008,3,9,0,129755,23000,152755,23000,Americas
Chile,2010,2,562,10334,1861372,800000,2671706,30000000,Americas
Chile,2011,5,1,0,54850,1082,55932,200000,Americas
Chile,2012,3,8,14,28583,0,28597,303100,Americas
China P Rep,2000,29,678,3949,24987300,410124,25401373,1491185,Asia
China P Rep,2001,32,922,91071,39421148,854215,40366434,4449000,Asia
China P Rep,2002,29,1795,39501,285252982,2348,285294831,6156800,Asia
China P Rep,2003,27,1092,158496,217588053,1805886,219552435,16368511,Asia
China P Rep,2004,25,823,23623,52241849,684124,52949596,4327480,Asia
China P Rep,2005,31,1058,11364,83650910,281000,83943274,11822775,Asia
China P Rep,2006,37,2109,7117,88101145,631160,88739422,12463691,Asia
China P Rep,2007,20,1161,4821,120041600,69855,120116276,8004698,Asia
China P Rep,2008,30,88450,368719,136193000,414235,136975954,111233000,Asia
China P Rep,2009,26,575,953,128603348,158450,128762751,9031552,Asia
China P Rep,2010,26,7186,13552,180286500,356625,180656677,22675436,Asia
China P Rep,2011,20,746,1057,123963401,308425,124272883,12048115,Asia
China P Rep,2012,29,802,38567,44518500,48618,44605685,19834533,Asia
China P Rep,2013,17,632,13167,5153170,16540,5182877,10784000,Asia
Colombia,2000,4,115,0,40430,39000,79430,0,Americas
Colombia,2001,6,99,232,6000,7500,13732,0,Americas
Colombia,2002,5,135,13,124525,2000,126538,0,Americas
Colombia,2003,5,91,78,74700,60,74838,0,Americas
Colombia,2004,4,116,142,539378,500,540020,0,Americas
Colombia,2005,5,180,261,604679,0,604940,10000,Americas
Colombia,2006,3,150,227,238238,0,238465,0,Americas
Colombia,2007,6,218,265,1611253,2000,1613518,0,Americas
Colombia,2008,9,155,168,1272351,1700,1274219,10000,Americas
Colombia,2009,3,53,7,31250,593,31850,0,Americas
Colombia,2010,6,571,463,2796297,0,2796760,1000000,Americas
Colombia,2011,3,313,262,1487436,0,1487698,2320000,Americas
Colombia,2012,5,85,18,143899,8000,151917,102000,Americas
Colombia,2013,1,0,15,12000,0,12015,0,Americas
Comoros,2003,1,0,0,0,300,300,0,Africa
Comoros,2005,4,1,0,286282,0,286282,0,Africa
Comoros,2006,1,0,0,0,0,0,0,Africa
Comoros,2007,1,29,0,1490,0,1490,0,Africa
Comoros,2009,1,2,0,2500,0,2500,0,Africa
Comoros,2012,1,4,150,64987,0,65137,5000,Africa
Congo,2000,1,24,0,0,0,0,0,Africa
Congo,2001,1,19,0,13,0,13,0,Africa
Congo,2002,2,128,0,5015,48000,53015,0,Africa
Congo,2003,1,29,0,2,0,2,0,Africa
Congo,2005,3,17,5,2,3500,3507,0,Africa
Congo,2006,2,56,0,3030,5000,8030,0,Africa
Congo,2007,1,0,0,20000,5000,25000,0,Africa
Congo,2008,2,26,103,527,0,630,0,Africa
Congo,2010,1,219,0,524,0,524,0,Africa
Congo,2011,3,65,0,10819,0,10819,0,Africa
Congo,2012,3,24,89,2082,7500,9671,0,Africa
Cook Is,2001,1,0,0,744,0,744,0,Oceania
Cook Is,2005,1,0,8,600,0,608,0,Oceania
Cook Is,2009,1,0,0,1247,0,1247,0,Oceania
Cook Is,2010,1,0,8,2194,0,2202,0,Oceania
Costa Rica,2000,1,7,0,200,0,200,0,Americas
Costa Rica,2001,2,0,0,1437,0,1437,1000,Americas
Costa Rica,2002,2,10,40,95000,0,95040,1000,Americas
Costa Rica,2003,2,3,75,2560,0,2635,0,Americas
Costa Rica,2004,3,10,0,3311,25,3336,0,Americas
Costa Rica,2005,3,6,0,4072,0,4072,45000,Americas
Costa Rica,2007,2,19,0,24500,0,24500,80000,Americas
Costa Rica,2008,4,11,0,209498,0,209498,0,Americas
Costa Rica,2009,1,31,91,128527,0,128618,200000,Americas
Costa Rica,2010,3,27,0,3106,0,3106,0,Americas
Costa Rica,2011,1,4,0,46695,0,46695,0,Americas
Costa Rica,2012,2,8,225,10060,0,10285,45000,Americas
Cote d'Ivoire,2001,2,196,0,3180,0,3180,0,Africa
Cote d'Ivoire,2002,3,77,0,861,0,861,0,Africa
Cote d'Ivoire,2005,1,40,0,210,0,210,0,Africa
Cote d'Ivoire,2006,2,42,0,451,0,451,0,Africa
Cote d'Ivoire,2007,2,30,0,2150,0,2150,0,Africa
Cote d'Ivoire,2008,2,50,0,450,0,450,0,Africa
Cote d'Ivoire,2009,1,27,6,0,10000,10006,0,Africa
Cote d'Ivoire,2010,2,18,0,6425,0,6425,0,Africa
Croatia,2000,3,41,200,600,0,800,257750,Europe
Croatia,2001,1,0,0,1200,0,1200,0,Europe
Croatia,2003,3,788,0,0,0,0,350000,Europe
Croatia,2005,3,7,0,250,0,250,0,Europe
Croatia,2006,1,0,0,0,0,0,0,Europe
Croatia,2007,2,12,26,0,0,26,0,Europe
Croatia,2010,3,0,0,1110,0,1110,80000,Europe
Croatia,2012,3,7,0,1500,0,1500,0,Europe
Cuba,2000,2,2,0,675,0,675,0,Americas
Cuba,2001,1,5,12,5900000,0,5900012,100000,Americas
Cuba,2002,3,3,0,358970,0,358970,46000,Americas
Cuba,2003,1,0,0,600,0,600,0,Americas
Cuba,2004,3,4,5,205745,41500,247250,1203139,Americas
Cuba,2005,2,20,0,2600000,0,2600000,2100000,Americas
Cuba,2006,2,2,8,1760,0,1768,0,Americas
Cuba,2007,3,1,0,210488,0,210488,500000,Americas
Cuba,2008,5,7,19,519445,0,519464,3572000,Americas
Cuba,2012,3,14,0,48355,75141,123496,0,Americas
Cyprus,2000,3,5,400,0,0,400,0,Asia
Cyprus,2003,1,0,30,0,0,30,10000,Asia
Cyprus,2004,1,0,10,0,0,10,0,Asia
Cyprus,2007,1,4,0,0,0,0,0,Asia
Czech Rep,2000,1,0,0,0,0,0,80000,Europe
Czech Rep,2002,3,20,0,200000,0,200000,2420000,Europe
Czech Rep,2003,1,418,0,0,0,0,0,Europe
Czech Rep,2005,3,16,3,0,0,3,0,Europe
Czech Rep,2006,2,6,0,4315,0,4315,0,Europe
Czech Rep,2007,1,4,0,0,0,0,150000,Europe
Czech Rep,2008,1,2,0,0,0,0,50000,Europe
Czech Rep,2009,2,15,12,14450,0,14462,150000,Europe
Czech Rep,2010,4,23,0,1400,0,1400,347560,Europe
Czech Rep,2012,2,32,0,0,0,0,0,Europe
Czech Rep,2013,1,4,0,0,0,0,0,Europe
Denmark,2002,1,1,0,0,0,0,0,Europe
Denmark,2005,1,4,0,0,0,0,1300000,Europe
Denmark,2007,1,0,0,0,0,0,100000,Europe
Denmark,2010,1,0,0,0,0,0,0,Europe
Djibouti,2000,1,4,0,419,0,419,0,Africa
Djibouti,2004,1,51,0,98500,1500,100000,0,Africa
Djibouti,2005,1,0,0,150000,0,150000,0,Africa
Djibouti,2007,2,6,0,43312,0,43312,0,Africa
Djibouti,2008,1,0,0,340000,0,340000,0,Africa
Djibouti,2010,1,0,0,200258,0,200258,0,Africa
Dominica,2001,1,3,0,175,0,175,0,Americas
Dominica,2004,1,0,0,100,0,100,0,Americas
Dominica,2007,1,2,30,7500,0,7530,20000,Americas
Dominica,2011,1,0,0,144,96,240,0,Americas
Dominican Rep,2001,1,3,0,0,0,0,10,Americas
Dominican Rep,2002,1,3,0,1750,0,1750,500,Americas
Dominican Rep,2003,4,21,18,77460,0,77478,44720,Americas
Dominican Rep,2004,4,703,9,22160,2092,24261,297000,Americas
Dominican Rep,2005,3,12,0,2450,0,2450,0,Americas
Dominican Rep,2007,5,175,0,162763,0,162763,162700,Americas
Dominican Rep,2008,3,13,2,17000,0,17002,0,Americas
Dominican Rep,2009,3,32,0,17835,0,17835,52403,Americas
Dominican Rep,2010,4,137,0,64521,0,64521,0,Americas
Dominican Rep,2011,4,12,220,55200,0,55420,30000,Americas
Dominican Rep,2012,5,172,0,71675,11500,83175,0,Americas
Ecuador,2000,5,86,87,100370,180,100637,0,Americas
Ecuador,2001,3,58,30,32270,0,32300,10975,Americas
Ecuador,2002,6,91,6,201350,3027,204383,16000,Americas
Ecuador,2003,2,0,0,32905,0,32905,0,Americas
Ecuador,2006,3,21,13,357920,0,357933,152800,Americas
Ecuador,2008,1,41,0,275000,14122,289122,1000000,Americas
Ecuador,2009,2,3,2,119305,0,119307,1700,Americas
Ecuador,2010,4,18,0,12940,500,13440,0,Americas
Ecuador,2011,2,7,0,3750,0,3750,0,Americas
Ecuador,2012,3,45,140,80632,0,80772,0,Americas
Ecuador,2013,1,14,0,0,0,0,0,Americas
Egypt,2000,1,3,105,0,0,105,0,Africa
Egypt,2002,3,18,70,1050,0,1120,0,Africa
Egypt,2004,3,28,42,143,0,185,0,Africa
Egypt,2008,1,98,72,0,625,697,0,Africa
Egypt,2010,3,58,40,3500,0,3540,0,Africa
El Salvador,2000,3,27,0,711,0,711,0,Americas
El Salvador,2001,4,1159,8122,1983428,0,1991550,1870900,Americas
El Salvador,2002,3,7,0,2999,0,2999,0,Americas
El Salvador,2003,1,304,0,50000,0,50000,0,Americas
El Salvador,2005,6,120,1,77223,0,77224,355700,Americas
El Salvador,2006,2,1,0,16470,0,16470,0,Americas
El Salvador,2007,2,2,0,3300,0,3300,0,Americas
El Salvador,2008,2,30,0,3000,0,3000,0,Americas
El Salvador,2009,3,282,0,79598,15000,94598,966000,Americas
El Salvador,2010,3,17,3,9217,2800,12020,20000,Americas
El Salvador,2011,1,35,0,300000,0,300000,1000000,Americas
Equatorial Guinea,2004,1,15,0,946,0,946,0,Africa
Estonia,2005,2,3,0,100,0,100,130000,Europe
Estonia,2012,1,1,0,0,0,0,0,Europe
Ethiopia,2000,9,495,5,37033,165,37203,0,Africa
Ethiopia,2001,5,434,0,47666,0,47666,0,Africa
Ethiopia,2002,2,34,0,4000,0,4000,0,Africa
Ethiopia,2003,2,119,0,12710000,0,12710000,0,Africa
Ethiopia,2005,8,285,0,2852382,0,2852382,6200,Africa
Ethiopia,2006,9,1302,96,466898,0,466994,3200,Africa
Ethiopia,2007,3,22,0,247386,0,247386,0,Africa
Ethiopia,2008,5,65,35,6518729,810,6519574,0,Africa
Ethiopia,2009,2,135,0,6213652,0,6213652,0,Africa
Ethiopia,2010,4,35,0,4887346,0,4887346,0,Africa
Ethiopia,2011,1,0,0,40200,0,40200,0,Africa
Ethiopia,2012,1,0,0,1000000,0,1000000,0,Africa
Fiji,2000,1,4,0,0,0,0,0,Oceania
Fiji,2001,1,1,0,0,0,0,0,Oceania
Fiji,2003,1,17,0,30000,0,30000,30000,Oceania
Fiji,2004,2,16,0,5600,0,5600,4000,Oceania
Fiji,2005,1,0,0,0,0,0,0,Oceania
Fiji,2006,2,4,0,392,0,392,500,Oceania
Fiji,2007,4,7,0,969,0,969,37652,Oceania
Fiji,2008,1,7,0,0,0,0,0,Oceania
Fiji,2009,2,14,0,14401,0,14401,56547,Oceania
Fiji,2010,1,2,0,39101,0,39101,39427,Oceania
Fiji,2012,3,17,0,27945,0,27945,97400,Oceania
Finland,2005,1,0,0,400,0,400,0,Europe
France,2000,7,11,19,2300,200,2519,0,Europe
France,2001,7,17,121,17181,0,17302,132350,Europe
France,2002,6,29,3,3736,0,3739,1191000,Europe
France,2003,6,19511,74,30000,0,30074,5900050,Europe
France,2004,1,11,0,0,0,0,0,Europe
France,2005,5,13,0,4000,0,4000,10000,Europe
France,2006,3,1393,2,600,0,602,0,Europe
France,2007,3,5,0,900,0,900,250000,Europe
France,2008,4,7,6,2100,600,2706,80000,Europe
France,2009,4,16,200,0,0,200,3200000,Europe
France,2010,4,81,79,500000,0,500079,5730000,Europe
France,2011,2,3,0,2300,0,2300,0,Europe
France,2012,1,12,0,0,0,0,0,Europe
France,2013,1,2,0,2000,0,2000,655000,Europe
French Polynesia,2010,1,1,11,3400,0,3411,11000,Oceania
Gabon,2001,1,50,0,10,0,10,0,Africa
Gabon,2004,1,1,0,100,0,100,0,Africa
Gabon,2007,1,0,0,17900,0,17900,0,Africa
Gabon,2009,1,0,0,0,800,800,0,Africa
Gabon,2010,3,0,0,2316,0,2316,0,Africa
Gabon,2012,1,1,0,77845,0,77845,0,Africa
Gambia The,2000,1,21,0,116,0,116,0,Africa
Gambia The,2001,1,1,0,250,0,250,0,Africa
Gambia The,2002,1,0,0,0,0,0,0,Africa
Gambia The,2003,1,3,19,8000,0,8019,0,Africa
Gambia The,2004,2,2,112,6025,0,6137,0,Africa
Gambia The,2007,1,0,0,300,0,300,0,Africa
Gambia The,2008,2,0,0,300,400,700,0,Africa
Gambia The,2009,2,5,0,16608,0,16608,0,Africa
Gambia The,2010,2,9,0,38961,0,38961,0,Africa
Gambia The,2012,1,0,0,428000,0,428000,0,Africa
Georgia,2000,1,0,0,696000,0,696000,200000,Asia
Georgia,2001,1,0,0,900,0,900,0,Asia
Georgia,2002,1,6,70,18000,1086,19156,350000,Asia
Georgia,2004,2,1,0,0,90,90,2156,Asia
Georgia,2005,1,0,0,2500,0,2500,0,Asia
Georgia,2006,1,0,0,600,0,600,0,Asia
Georgia,2009,1,0,6,7300,0,7306,0,Asia
Georgia,2011,1,7,0,1750,0,1750,0,Asia
Georgia,2012,2,5,36,100000,6000,106036,94000,Asia
Germany,2001,1,6,0,0,0,0,300000,Europe
Germany,2002,6,49,127,330609,0,330736,13650000,Europe
Germany,2003,3,9370,0,0,0,0,1950000,Europe
Germany,2004,2,2,0,150,0,150,142000,Europe
Germany,2005,5,14,167,450,0,617,790000,Europe
Germany,2006,5,13,300,1000,0,1300,0,Europe
Germany,2007,3,19,130,0,0,130,5500000,Europe
Germany,2008,3,9,0,0,0,0,2700000,Europe
Germany,2009,3,15,0,0,0,0,70000,Europe
Germany,2010,4,8,0,0,0,0,1000000,Europe
Germany,2011,1,4,0,0,0,0,0,Europe
Germany,2012,2,6,0,0,0,0,0,Europe
Germany,2013,1,0,0,0,0,0,0,Europe
Ghana,2001,3,24,25,140141,5000,145166,0,Africa
Ghana,2002,2,4,0,2200,0,2200,0,Africa
Ghana,2005,1,40,0,2248,0,2248,0,Africa
Ghana,2007,1,56,0,332600,0,332600,0,Africa
Ghana,2008,1,0,0,58000,0,58000,0,Africa
Ghana,2009,2,40,0,159545,0,159545,0,Africa
Ghana,2010,3,90,0,17274,0,17274,0,Africa
Ghana,2011,3,121,12,104034,0,104046,0,Africa
Ghana,2012,2,76,0,5441,0,5441,0,Africa
Ghana,2013,1,18,250,310,0,560,0,Africa
Greece,2000,6,37,195,7200,90,7485,3000,Europe
Greece,2001,3,11,0,1350,0,1350,0,Europe
Greece,2002,6,2,29,540,0,569,0,Europe
Greece,2003,4,0,50,450,0,500,600000,Europe
Greece,2004,2,0,0,0,0,0,340000,Europe
Greece,2006,3,4,0,3690,0,3690,5659,Europe
Greece,2007,4,88,68,2193,3735,5996,1750000,Europe
Greece,2008,1,2,240,3468,0,3708,0,Europe
Greece,2009,2,0,0,715,325,1040,0,Europe
Greece,2010,1,1,0,150,0,150,0,Europe
Greece,2012,2,6,0,200,0,200,0,Europe
Grenada,2004,1,39,0,60000,0,60000,889000,Americas
Grenada,2005,1,1,0,1650,0,1650,0,Americas
Grenada,2010,1,0,0,0,0,0,0,Americas
Guadeloupe,2004,1,1,13,100,40,153,0,Americas
Guadeloupe,2007,1,0,0,0,0,0,300000,Americas
Guadeloupe,2010,1,0,0,33000,0,33000,0,Americas
Guam,2002,2,1,0,10044,5100,15144,130000,Oceania
Guam,2004,2,1,0,300,0,300,1000,Oceania
Guatemala,2000,3,36,36,3500,250,3786,0,Americas
Guatemala,2001,4,55,13,122031,0,122044,14150,Americas
Guatemala,2002,5,71,14,102282,460,102756,100,Americas
Guatemala,2003,2,22,0,220,0,220,0,Americas
Guatemala,2005,4,1583,426,477428,0,477854,988300,Americas
Guatemala,2006,1,6,0,0,0,0,0,Americas
Guatemala,2007,3,11,0,6001,0,6001,0,Americas
Guatemala,2008,4,74,0,197300,0,197300,0,Americas
Guatemala,2009,3,36,0,2512837,991,2513828,0,Americas
Guatemala,2010,6,227,210,405058,50640,455908,1150000,Americas
Guatemala,2011,7,83,18,537853,0,537871,61913,Americas
Guatemala,2012,3,44,178,1598049,0,1598227,210000,Americas
Guinea,2000,2,194,0,322,0,322,0,Africa
Guinea,2001,2,21,0,220143,0,220143,0,Africa
Guinea,2002,1,23,0,123,0,123,0,Africa
Guinea,2003,1,24,0,43,0,43,0,Africa
Guinea,2004,2,100,0,1092,777,1869,0,Africa
Guinea,2005,1,72,0,1884,0,1884,0,Africa
Guinea,2006,3,129,0,1498,0,1498,0,Africa
Guinea,2007,2,90,0,23095,0,23095,0,Africa
Guinea,2008,1,0,0,4200,0,4200,0,Africa
Guinea,2009,1,2,0,40000,0,40000,0,Africa
Guinea,2010,2,8,6,48020,0,48026,0,Africa
Guinea,2011,1,0,0,16143,4000,20143,0,Africa
Guinea,2012,1,105,0,5523,0,5523,0,Africa
Guinea Bissau,2002,1,0,0,100000,0,100000,0,Africa
Guinea Bissau,2003,1,0,0,0,0,0,0,Africa
Guinea Bissau,2004,2,6,0,199,1000,1199,0,Africa
Guinea Bissau,2005,1,399,0,25111,0,25111,0,Africa
Guinea Bissau,2006,1,0,0,32000,0,32000,0,Africa
Guinea Bissau,2008,2,221,0,14004,750,14754,0,Africa
Guinea Bissau,2010,1,2,0,56792,0,56792,0,Africa
Guyana,2000,1,10,0,0,0,0,0,Americas
Guyana,2005,1,34,0,274774,0,274774,465100,Americas
Guyana,2006,1,0,0,35000,0,35000,169000,Americas
Guyana,2008,1,0,0,100000,0,100000,0,Americas
Guyana,2010,1,0,0,0,0,0,14700,Americas
Haiti,2000,2,16,0,0,1200,1200,0,Americas
Haiti,2001,2,26,11,5070,0,5081,20,Americas
Haiti,2002,2,35,4,38585,0,38589,1000,Americas
Haiti,2003,6,128,75,185200,12470,197745,0,Americas
Haiti,2004,3,5422,2773,334056,16548,353377,51000,Americas
Haiti,2005,8,88,58,41818,185,42061,50500,Americas
Haiti,2006,3,16,10,39690,0,39700,0,Americas
Haiti,2007,7,163,233,203700,16109,220042,0,Americas
Haiti,2008,4,698,86,246160,30,246276,0,Americas
Haiti,2009,3,21,0,2796,9910,12706,0,Americas
Haiti,2010,7,229549,577520,3736706,0,4314226,8000000,Americas
Haiti,2011,4,39,12,6930,540,7482,0,Americas
Haiti,2012,7,180,27,208782,33330,242139,254000,Americas
Haiti,2013,1,6,0,0,33265,33265,0,Americas
Honduras,2000,2,0,0,1125,0,1125,0,Americas
Honduras,2001,2,21,0,256051,25270,281321,5000,Americas
Honduras,2002,5,19,0,89075,144,89219,100000,Americas
Honduras,2003,2,10,5,3100,0,3105,20000,Americas
Honduras,2004,1,0,0,137500,0,137500,0,Americas
Honduras,2005,5,61,0,103869,800,104669,115500,Americas
Honduras,2006,1,4,0,1500,0,1500,8000,Americas
Honduras,2007,4,7,18,35000,1865,36883,6579,Americas
Honduras,2008,2,67,7,313350,0,313357,0,Americas
Honduras,2009,3,14,136,106771,0,106907,100000,Americas
Honduras,2010,5,211,14,48673,7998,56685,90000,Americas
Honduras,2011,1,33,0,69798,0,69798,0,Americas
Honduras,2012,1,0,0,125000,0,125000,0,Americas
Hong Kong (China),2002,1,299,0,1456,0,1456,0,Asia
Hong Kong (China),2003,2,4,33,3500,0,3533,0,Asia
Hong Kong (China),2005,1,0,0,0,0,0,0,Asia
Hong Kong (China),2008,3,2,207,0,0,207,380,Asia
Hong Kong (China),2009,1,0,50,300,0,350,0,Asia
Hong Kong (China),2010,1,1,0,15000,0,15000,0,Asia
Hungary,2000,2,1,0,2000,0,2000,55000,Europe
Hungary,2001,2,81,0,10000,0,10000,5000,Europe
Hungary,2002,1,0,0,1430,0,1430,30000,Europe
Hungary,2003,2,7,0,0,0,0,100000,Europe
Hungary,2004,1,0,0,384,9,393,0,Europe
Hungary,2005,4,52,0,0,0,0,48000,Europe
Hungary,2006,2,5,300,32000,0,32300,10000,Europe
Hungary,2007,1,500,0,0,0,0,0,Europe
Hungary,2008,1,17,500,0,0,500,0,Europe
Hungary,2010,1,1,0,2000,0,2000,440000,Europe
Hungary,2012,1,16,0,0,0,0,0,Europe
Hungary,2013,1,0,0,1800,0,1800,0,Europe
Iceland,2000,2,0,1,129,69,199,12000,Europe
Iceland,2010,1,0,0,0,0,0,0,Europe
India,2000,22,2817,54,100172886,252000,100424940,1495500,Asia
India,2001,22,21045,166852,25058889,1792000,27017741,2984924,Asia
India,2002,19,2991,300,342023353,5200,342028853,961910,Asia
India,2003,17,2251,4609,7857090,236345,8098044,613000,Asia
India,2004,7,17737,6913,33748599,105000,33860512,3798800,Asia
India,2005,31,4997,6803,28196813,464000,28667616,7240000,Asia
India,2006,20,1431,478,3234000,4150000,7384478,3390000,Asia
India,2007,20,2236,33,38143000,0,38143033,376151,Asia
India,2008,11,1808,50,11589018,2400000,13989068,145000,Asia
India,2009,18,2249,118,8992521,4000,8996639,2734000,Asia
India,2010,17,1317,305,3882863,907000,4790168,2149000,Asia
India,2011,13,1038,250,12504069,325000,12829319,2032625,Asia
India,2012,10,599,0,4280860,0,4280860,244000,Asia
India,2013,4,610,70,134280,0,134350,0,Asia
Indonesia,2000,15,564,3148,740156,61145,804449,240600,Asia
Indonesia,2001,10,587,16,92500,29600,122116,20000,Asia
Indonesia,2002,16,290,1695,607684,0,609379,351600,Asia
Indonesia,2003,16,534,361,687504,140,688005,4961,Asia
Indonesia,2004,19,166691,1376,262445,532898,796719,4583100,Asia
Indonesia,2005,10,1238,1419,151707,0,153126,5000,Asia
Indonesia,2006,18,7421,138952,3090086,708365,3937403,3314243,Asia
Indonesia,2007,19,979,2861,1210620,46675,1260156,1671000,Asia
Indonesia,2008,17,144,162,484440,2920,487522,1733,Asia
Indonesia,2009,12,1485,3623,2873550,0,2877173,2381000,Asia
Indonesia,2010,12,1294,4309,216133,4830,225272,78000,Asia
Indonesia,2011,12,129,9,18232,10095,28336,5850,Asia
Indonesia,2012,15,107,336,48230,3845,52411,1000,Asia
Indonesia,2013,6,118,210,421886,0,422096,3000000,Asia
Iran Islam Rep,2000,7,90,15,2900,6000,8915,6000,Asia
Iran Islam Rep,2001,5,476,284,1206250,0,1206534,103800,Asia
Iran Islam Rep,2002,9,291,1406,345750,4500,351656,363060,Asia
Iran Islam Rep,2003,7,26817,22743,208550,67130,298423,522504,Asia
Iran Islam Rep,2004,4,75,331,2720,4000,7051,240,Asia
Iran Islam Rep,2005,9,734,1621,126267,1750,129638,80000,Asia
Iran Islam Rep,2006,4,77,1494,169800,0,171294,58262,Asia
Iran Islam Rep,2007,2,24,9,160000,0,160009,22000,Asia
Iran Islam Rep,2008,5,56,295,21900,0,22195,0,Asia
Iran Islam Rep,2009,1,0,269,0,0,269,0,Asia
Iran Islam Rep,2010,6,11,535,750,3500,4785,0,Asia
Iran Islam Rep,2012,4,319,2267,66040,0,68307,500000,Asia
Iran Islam Rep,2013,2,37,850,0,4000,4850,0,Asia
Iraq,2003,1,0,0,0,0,0,0,Asia
Iraq,2004,2,2,0,8000,0,8000,0,Asia
Iraq,2006,2,20,20,59890,0,59910,1300,Asia
Iraq,2007,1,24,0,4696,0,4696,0,Asia
Iraq,2008,2,15,0,892,600,1492,0,Asia
Iraq,2009,1,2,0,3000,0,3000,0,Asia
Iraq,2011,1,6,1,0,2000,2001,0,Asia
Iraq,2012,1,4,0,0,0,0,0,Asia
Ireland,2000,3,3,0,1374,0,1374,100000,Europe
Ireland,2002,2,0,0,301,0,301,0,Europe
Ireland,2004,1,0,0,200,0,200,0,Europe
Ireland,2005,1,0,0,0,0,0,0,Europe
Ireland,2009,1,0,0,0,0,0,0,Europe
Ireland,2011,1,2,0,600,0,600,325000,Europe
Israel,2000,3,15,0,549,0,549,2750,Asia
Israel,2010,2,46,22,20000,0,20022,270000,Asia
Italy,2000,4,46,22,46000,0,46022,8050000,Europe
Italy,2001,4,2,0,0,0,0,278100,Europe
Italy,2002,9,37,62,20001,9500,29563,1942000,Europe
Italy,2003,4,20092,2,1580,0,1582,5766352,Europe
Italy,2004,1,2,0,200,0,200,0,Europe
Italy,2005,1,9,0,0,0,0,0,Europe
Italy,2006,2,5,9,150,0,159,0,Europe
Italy,2007,2,17,0,0,0,0,0,Europe
Italy,2008,3,9,0,300,0,300,278000,Europe
Italy,2009,5,335,1140,0,60000,61140,2635000,Europe
Italy,2010,3,3,5,300,0,305,872000,Europe
Italy,2011,4,29,1,0,0,1,545000,Europe
Italy,2012,5,73,400,11500,14700,26600,17137601,Europe
Jamaica,2000,1,0,0,0,0,0,6000,Americas
Jamaica,2001,1,1,0,0,200,200,55487,Americas
Jamaica,2002,3,13,0,26500,0,26500,21030,Americas
Jamaica,2004,2,16,6,350120,0,350126,895000,Americas
Jamaica,2005,3,6,0,10396,0,10396,34500,Americas
Jamaica,2006,2,4,0,5280,0,5280,0,Americas
Jamaica,2007,2,5,0,32000,1188,33188,300000,Americas
Jamaica,2008,2,13,0,4000,0,4000,66198,Americas
Jamaica,2010,1,15,26,2480,0,2506,150000,Americas
Jamaica,2012,1,1,0,215850,0,215850,0,Americas
Japan,2000,8,32,381,576090,312,576783,9990000,Asia
Japan,2001,6,25,529,20746,12,21287,1800000,Asia
Japan,2002,6,7,255,100792,0,101047,25500,Asia
Japan,2003,6,46,1672,22593,219,24484,1319000,Asia
Japan,2004,13,359,4973,410846,5800,421619,45093500,Asia
Japan,2005,6,136,1947,276427,0,278374,1433000,Asia
Japan,2006,5,62,747,22587,99,23433,2500000,Asia
Japan,2007,8,87,4465,64089,40668,109222,13810000,Asia
Japan,2008,3,29,651,50270,0,50921,277000,Asia
Japan,2009,5,61,438,32400,0,32838,1400000,Asia
Japan,2010,2,180,0,15000,0,15000,0,Asia
Japan,2011,7,19975,28428,364187,0,392615,212520000,Asia
Japan,2012,7,173,2602,99686,0,102288,1702400,Asia
Japan,2013,2,2,1601,8406,0,10007,0,Asia
Jordan,2000,3,9,212,150000,0,150212,0,Asia
Jordan,2002,1,5,25,0,0,25,0,Asia
Kazakhstan,2000,2,0,0,2614,0,2614,1500,Asia
Kazakhstan,2001,2,3,12,3668,0,3680,0,Asia
Kazakhstan,2003,1,3,626,36000,0,36626,0,Asia
Kazakhstan,2004,1,48,0,0,0,0,0,Asia
Kazakhstan,2005,1,0,0,25000,0,25000,7662,Asia
Kazakhstan,2008,1,1,0,13000,0,13000,130000,Asia
Kazakhstan,2010,2,44,700,23500,5000,29200,34576,Asia
Kazakhstan,2011,1,2,0,12238,3762,16000,67000,Asia
Kazakhstan,2012,2,0,0,14400,0,14400,0,Asia
Kenya,2000,5,50,0,721,0,721,0,Africa
Kenya,2001,5,44,0,743,0,743,38,Africa
Kenya,2002,5,101,8,175000,0,175008,0,Africa
Kenya,2003,2,40,0,60300,0,60300,0,Africa
Kenya,2004,5,143,0,2312141,0,2312141,100000,Africa
Kenya,2005,6,106,0,3537845,0,3537845,500,Africa
Kenya,2006,7,395,0,783888,0,783888,0,Africa
Kenya,2007,4,39,7,42650,0,42657,0,Africa
Kenya,2008,9,112,20,3862438,0,3862458,0,Africa
Kenya,2009,5,307,0,146646,0,146646,0,Africa
Kenya,2010,6,261,0,4515044,0,4515044,0,Africa
Kenya,2011,3,33,0,95692,5000,100692,0,Africa
Kenya,2012,2,73,0,4030670,0,4030670,100000,Africa
Kenya,2013,1,66,19,100000,0,100019,36000,Africa
Kiribati,2008,1,0,0,0,85,85,0,Oceania
Korea Dem P Rep,2000,1,46,180,480000,147000,627180,6000000,Asia
Korea Dem P Rep,2001,2,124,84,157500,30000,187584,9400,Asia
Korea Dem P Rep,2002,2,3,436,45771,19637,65844,500,Asia
Korea Dem P Rep,2004,2,24,0,450,199255,199705,20000,Asia
Korea Dem P Rep,2005,1,193,205,0,16093,16298,0,Asia
Korea Dem P Rep,2006,3,282,14,10310,84500,94824,0,Asia
Korea Dem P Rep,2007,2,610,518,1000000,171649,1172167,300000,Asia
Korea Dem P Rep,2010,3,20,0,95785,0,95785,0,Asia
Korea Dem P Rep,2011,3,74,887,56705,0,57592,0,Asia
Korea Dem P Rep,2012,3,147,145,3103905,33500,3137550,11400,Asia
Korea Dem P Rep,2013,1,5,0,0,23770,23770,0,Asia
Korea Rep,2000,6,61,18,40031,4137,44186,132300,Asia
Korea Rep,2001,4,81,300,310000,0,310300,366000,Asia
Korea Rep,2002,5,225,7,92628,0,92635,4555000,Asia
Korea Rep,2003,1,130,0,65000,15000,80000,4500000,Asia
Korea Rep,2004,7,24,0,6691,3077,9768,827595,Asia
Korea Rep,2005,5,29,0,15910,1840,17750,165500,Asia
Korea Rep,2006,1,46,0,4630,0,4630,0,Asia
Korea Rep,2007,2,23,2,1000,600,1602,70000,Asia
Korea Rep,2008,1,10,13,0,0,13,0,Asia
Korea Rep,2010,1,12,0,41500,0,41500,0,Asia
Korea Rep,2011,3,121,0,29000,2000,31000,52000,Asia
Korea Rep,2012,3,22,0,3120,0,3120,799000,Asia
Kuwait,2002,1,0,0,1,0,1,0,Asia
Kyrgyzstan,2000,1,11,0,0,0,0,0,Asia
Kyrgyzstan,2002,1,0,0,480,522,1002,1500,Asia
Kyrgyzstan,2003,1,38,2,156,53,211,0,Asia
Kyrgyzstan,2004,3,49,18,0,80,98,0,Asia
Kyrgyzstan,2005,1,3,0,0,2050,2050,2660,Asia
Kyrgyzstan,2006,2,4,0,21075,50,21125,0,Asia
Kyrgyzstan,2007,1,0,0,845,0,845,200,Asia
Kyrgyzstan,2008,2,74,142,3000,1055,4197,0,Asia
Kyrgyzstan,2009,1,0,0,2000000,0,2000000,0,Asia
Kyrgyzstan,2010,2,0,141,8350,0,8491,0,Asia
Kyrgyzstan,2011,1,0,0,0,0,0,0,Asia
Kyrgyzstan,2012,2,16,50,11000,0,11050,0,Asia
Lao P Dem Rep,2000,3,59,0,459685,0,459685,1000,Asia
Lao P Dem Rep,2001,1,0,0,453000,0,453000,0,Asia
Lao P Dem Rep,2002,1,2,0,150000,0,150000,0,Asia
Lao P Dem Rep,2004,1,2,0,0,0,0,0,Asia
Lao P Dem Rep,2008,1,6,0,204190,0,204190,0,Asia
Lao P Dem Rep,2009,2,26,91,128796,0,128887,100000,Asia
Lao P Dem Rep,2011,2,48,0,467000,0,467000,0,Asia
Latvia,2000,1,0,0,102,0,102,0,Europe
Latvia,2001,1,21,0,0,0,0,0,Europe
Latvia,2003,1,15,0,0,0,0,0,Europe
Latvia,2005,3,40,0,0,0,0,325000,Europe
Latvia,2012,1,10,0,0,0,0,0,Europe
Lebanon,2002,1,0,0,500,0,500,0,Asia
Lebanon,2003,1,0,0,17000,0,17000,0,Asia
Lebanon,2007,1,1,15,0,0,15,0,Asia
Lesotho,2000,1,28,0,1834,0,1834,0,Africa
Lesotho,2001,2,1,1,1000,1000,2001,0,Africa
Lesotho,2002,1,0,0,500000,0,500000,0,Africa
Lesotho,2007,1,0,0,475000,0,475000,0,Africa
Lesotho,2008,1,0,0,4500,0,4500,0,Africa
Lesotho,2011,3,26,0,730515,0,730515,0,Africa
Liberia,2000,2,13,0,112,0,112,0,Africa
Liberia,2002,1,0,0,661,0,661,0,Africa
Liberia,2003,2,0,0,19418,0,19418,0,Africa
Liberia,2005,1,29,0,674,0,674,0,Africa
Liberia,2007,2,1,0,17000,3500,20500,0,Africa
Liberia,2008,1,0,0,0,340,340,0,Africa
Liberia,2009,2,2,0,500584,0,500584,0,Africa
Liberia,2010,1,1,0,15486,0,15486,0,Africa
Lithuania,2001,1,20,0,0,0,0,0,Europe
Lithuania,2005,2,0,0,0,0,0,30000,Europe
Lithuania,2006,1,0,0,0,0,0,225573,Europe
Lithuania,2010,2,9,0,0,0,0,0,Europe
Lithuania,2012,2,30,0,0,0,0,0,Europe
Luxembourg,2003,1,170,0,0,0,0,0,Europe
Luxembourg,2010,1,0,0,0,0,0,31000,Europe
Macedonia FRY,2000,1,0,0,0,0,0,13563,Europe
Macedonia FRY,2001,1,15,0,0,0,0,0,Europe
Macedonia FRY,2002,2,0,0,1700,150,1850,0,Europe
Macedonia FRY,2003,2,2,0,4750,0,4750,0,Europe
Macedonia FRY,2004,2,15,0,100000,0,100000,3600,Europe
Macedonia FRY,2005,2,1,3,2000,0,2003,0,Europe
Macedonia FRY,2006,1,0,0,1500,0,1500,0,Europe
Macedonia FRY,2007,2,1,0,1000202,0,1000202,0,Europe
Macedonia FRY,2012,1,1,0,5100,0,5100,0,Europe
Macedonia FRY,2013,1,1,0,3000,0,3000,0,Europe
Madagascar,2000,3,153,1,1337498,0,1337499,9000,Africa
Madagascar,2002,5,694,1200,1143875,5000,1150075,181,Africa
Madagascar,2003,4,105,86,134429,51605,186120,150000,Africa
Madagascar,2004,2,395,979,773000,258450,1032429,250000,Africa
Madagascar,2005,4,107,25,72700,8877,81602,0,Africa
Madagascar,2006,2,4,0,6112,404,6516,0,Africa
Madagascar,2007,4,91,16,243495,12000,255511,240000,Africa
Madagascar,2008,5,125,580,1058768,194338,1253686,60000,Africa
Madagascar,2009,4,27,10,123389,8102,131501,5000,Africa
Madagascar,2010,1,120,132,192000,0,192132,0,Africa
Madagascar,2011,1,35,73,89297,25845,115215,0,Africa
Madagascar,2012,3,112,299,335300,0,335599,100000,Africa
Madagascar,2013,2,51,127,44752,0,44879,0,Africa
Malawi,2000,2,83,0,23323,0,23323,1000,Africa
Malawi,2001,5,1190,0,549016,0,549016,6700,Africa
Malawi,2002,5,725,0,3226548,0,3226548,0,Africa
Malawi,2003,2,12,0,18500,1000,19500,0,Africa
Malawi,2005,3,12,8,5100000,44500,5144508,0,Africa
Malawi,2006,3,28,0,852,16000,16852,0,Africa
Malawi,2007,5,2,0,719306,2659,721965,0,Africa
Malawi,2008,2,113,0,21649,0,21649,0,Africa
Malawi,2009,3,66,186,11461,20550,32197,0,Africa
Malawi,2010,1,0,0,21290,0,21290,0,Africa
Malawi,2011,3,4,1,83586,0,83587,0,Africa
Malawi,2012,4,4,0,1996735,0,1996735,0,Africa
Malawi,2013,1,0,0,33000,0,33000,0,Africa
Malaysia,2000,4,16,0,9488,0,9488,1000,Asia
Malaysia,2001,4,11,0,33200,0,33200,0,Asia
Malaysia,2002,3,14,0,158,0,158,0,Asia
Malaysia,2003,3,8,0,18800,0,18800,0,Asia
Malaysia,2004,6,97,767,57038,19296,77101,510000,Asia
Malaysia,2005,3,13,0,30600,0,30600,0,Asia
Malaysia,2006,4,6,0,106518,0,106518,22000,Asia
Malaysia,2007,3,102,0,137533,29000,166533,968000,Asia
Malaysia,2008,2,0,0,8000,0,8000,0,Asia
Malaysia,2009,2,0,0,10875,0,10875,0,Asia
Malaysia,2011,2,18,6,20000,0,20006,0,Asia
Maldives,2004,1,102,2214,12000,13000,27214,470100,Asia
Maldives,2007,1,0,0,1649,0,1649,0,Asia
Maldives,2011,1,4,0,1289,0,1289,0,Asia
Mali,2000,1,15,0,0,0,0,0,Africa
Mali,2001,2,2,0,3500,0,3500,0,Africa
Mali,2002,2,35,0,22801,0,22801,0,Africa
Mali,2003,2,106,0,1216,10000,11216,0,Africa
Mali,2004,1,0,0,0,0,0,0,Africa
Mali,2005,5,43,0,1000168,1860,1002028,0,Africa
Mali,2006,3,10,0,25151,1000,26151,0,Africa
Mali,2007,2,18,34,42662,46162,88858,0,Africa
Mali,2008,1,0,0,0,2500,2500,0,Africa
Mali,2009,2,35,16,20476,0,20492,0,Africa
Mali,2010,3,0,0,632000,0,632000,0,Africa
Mali,2011,3,50,0,3516605,0,3516605,0,Africa
Marshall Is,2000,1,6,0,218,0,218,0,Oceania
Marshall Is,2008,1,0,0,600,0,600,0,Oceania
Marshall Is,2013,1,0,0,6384,0,6384,0,Oceania
Martinique,2007,2,2,106,0,0,106,300000,Americas
Martinique,2010,1,13,0,29200,0,29200,0,Americas
Martinique,2011,1,1,0,0,0,0,0,Americas
Mauritania,2001,2,0,0,1000000,3000,1003000,0,Africa
Mauritania,2002,1,25,0,27500,0,27500,0,Africa
Mauritania,2003,1,9,0,0,21000,21000,0,Africa
Mauritania,2004,1,0,0,0,0,0,0,Africa
Mauritania,2005,2,55,0,10085,0,10085,0,Africa
Mauritania,2006,2,7,19,0,10600,10619,0,Africa
Mauritania,2007,2,3,0,54120,0,54120,0,Africa
Mauritania,2009,1,1,0,10000,0,10000,0,Africa
Mauritania,2010,2,0,0,846750,0,846750,0,Africa
Mauritania,2011,1,0,0,700000,0,700000,0,Africa
Mauritius,2002,1,3,50,0,1000,1050,50000,Africa
Mauritius,2005,1,0,0,2553,0,2553,0,Africa
Mauritius,2007,1,2,0,0,0,0,0,Africa
Mauritius,2013,1,11,82,0,0,82,0,Africa
Mexico,2000,8,236,1,73300,0,73301,1000,Americas
Mexico,2001,6,26,0,5600,800,6400,401000,Americas
Mexico,2002,8,103,230,516600,0,516830,1050000,Americas
Mexico,2003,8,70,1123,237530,3000,241653,216300,Americas
Mexico,2004,4,72,40,4050,0,4090,3600,Americas
Mexico,2005,7,88,0,2683571,300000,2983571,7910000,Americas
Mexico,2006,7,41,0,270700,0,270700,2700,Americas
Mexico,2007,7,58,0,1828000,30000,1858000,3600000,Americas
Mexico,2008,3,36,0,520000,0,520000,75000,Americas
Mexico,2009,8,32,14,293857,0,293871,40000,Americas
Mexico,2010,9,182,232,1600075,0,1600307,7066000,Americas
Mexico,2011,11,125,2,3610600,40000,3650602,597700,Americas
Mexico,2012,3,21,11,132000,4000,136011,1175000,Americas
Mexico,2013,1,4,0,12000,0,12000,0,Americas
Moldova Rep,2000,2,2,0,2600000,0,2600000,31600,Europe
Moldova Rep,2002,1,1,0,500,0,500,832,Europe
Moldova Rep,2005,2,13,0,6500,0,6500,7752,Europe
Moldova Rep,2007,1,0,0,210394,0,210394,406000,Europe
Moldova Rep,2008,1,3,0,4000,0,4000,0,Europe
Moldova Rep,2010,1,1,0,12000,0,12000,0,Europe
Moldova Rep,2012,2,10,0,13174,0,13174,0,Europe
Mongolia,2000,3,23,0,1521000,0,1521000,80000,Asia
Mongolia,2001,2,16,0,179000,0,179000,0,Asia
Mongolia,2002,3,3,0,665009,0,665009,0,Asia
Mongolia,2003,1,15,0,1500,150,1650,270,Asia
Mongolia,2008,2,52,0,3151,0,3151,0,Asia
Mongolia,2009,2,31,7,784106,0,784113,62094,Asia
Montenegro,2007,1,0,0,1086,0,1086,0,Europe
Montenegro,2009,1,0,0,450,0,450,0,Europe
Montenegro,2010,2,0,0,6350,0,6350,0,Europe
Montenegro,2012,1,1,0,4500,0,4500,0,Europe
Morocco,2000,3,6,0,950,0,950,809,Africa
Morocco,2001,1,15,0,300,0,300,2200,Africa
Morocco,2002,1,80,17,15000,0,15017,200000,Africa
Morocco,2003,1,35,0,10000,0,10000,0,Africa
Morocco,2004,2,628,926,0,12539,13465,400000,Africa
Morocco,2005,1,1,0,0,0,0,50,Africa
Morocco,2006,3,17,0,2100,0,2100,0,Africa
Morocco,2008,2,39,0,20000,0,20000,0,Africa
Morocco,2009,2,29,20,9500,0,9520,0,Africa
Morocco,2010,2,42,9,77000,0,77009,29000,Africa
Morocco,2012,1,0,0,7500,0,7500,0,Africa
Mozambique,2000,7,843,4,4518933,1050,4519987,420200,Africa
Mozambique,2001,5,95,0,1449937,0,1449937,36000,Africa
Mozambique,2002,3,20,17,2028,4500,6545,0,Africa
Mozambique,2003,9,217,13,681634,0,681647,0,Africa
Mozambique,2005,3,16,12,1438825,9000,1447837,0,Africa
Mozambique,2006,2,31,36,5692,1440,7168,0,Africa
Mozambique,2007,7,142,70,1088782,3500,1092352,171000,Africa
Mozambique,2008,5,238,36,687810,58000,745846,20000,Africa
Mozambique,2009,4,198,3,27301,6500,33804,3000,Africa
Mozambique,2010,3,49,0,480188,0,480188,0,Africa
Mozambique,2011,4,36,0,64271,0,64271,0,Africa
Mozambique,2012,3,33,13,109945,0,109958,0,Africa
Mozambique,2013,2,119,0,241144,0,241144,30000,Africa
Myanmar,2001,1,51,0,0,3750,3750,0,Asia
Myanmar,2002,1,21,0,50000,0,50000,0,Asia
Myanmar,2004,2,307,0,12500,28200,40700,500688,Asia
Myanmar,2005,1,17,16,0,0,16,0,Asia
Myanmar,2006,2,59,31,70075,0,70106,0,Asia
Myanmar,2007,5,35,110,162317,4237,166664,0,Asia
Myanmar,2008,1,138366,20000,2400000,0,2420000,4000000,Asia
Myanmar,2009,1,24,0,1351,0,1351,0,Asia
Myanmar,2010,2,113,49,405000,0,405049,57000,Asia
Myanmar,2011,2,225,125,53734,3152,57011,5300,Asia
Myanmar,2012,2,40,231,86255,0,86486,1170,Asia
Myanmar,2013,1,16,0,0,0,0,0,Asia
Namibia,2000,2,14,0,5058,0,5058,0,Africa
Namibia,2001,2,134,0,12098,0,12098,0,Africa
Namibia,2002,1,0,0,345000,0,345000,0,Africa
Namibia,2003,1,2,0,12000,0,12000,0,Africa
Namibia,2004,2,0,0,25000,0,25000,0,Africa
Namibia,2006,3,15,0,2347,0,2347,8490,Africa
Namibia,2007,2,14,0,15250,0,15250,0,Africa
Namibia,2008,2,51,0,65203,0,65203,0,Africa
Namibia,2009,1,92,0,350000,0,350000,0,Africa
Namibia,2010,1,8,0,110000,0,110000,0,Africa
Namibia,2011,1,108,0,500000,0,500000,12000,Africa
Namibia,2012,1,0,0,650,0,650,0,Africa
Namibia,2013,2,0,0,314500,0,314500,0,Africa
Nepal,2000,3,463,70,50592,0,50662,6300,Asia
Nepal,2001,3,170,0,21261,0,21261,0,Asia
Nepal,2002,3,564,305,265760,0,266065,0,Asia
Nepal,2003,2,287,284,43395,15575,59254,0,Asia
Nepal,2004,1,185,15,800000,0,800015,0,Asia
Nepal,2005,2,51,0,31600,0,31600,0,Asia
Nepal,2006,4,157,0,200000,80000,280000,0,Asia
Nepal,2007,1,214,48,640658,0,640706,2400,Asia
Nepal,2008,2,115,3,250000,0,250003,29,Asia
Nepal,2009,6,459,62,619598,0,619660,60000,Asia
Nepal,2010,4,223,0,13372,0,13372,0,Asia
Nepal,2011,7,182,121,194686,0,194807,123,Asia
Nepal,2012,3,135,5,0,0,5,1000,Asia
Netherlands,2002,1,4,0,0,0,0,300000,Europe
Netherlands,2003,1,965,0,0,0,0,0,Europe
Netherlands,2005,3,0,1,0,0,1,100000,Europe
Netherlands,2006,1,1000,0,0,0,0,0,Europe
Netherlands,2007,1,7,0,0,0,0,550000,Europe
Netherlands,2008,1,0,0,0,0,0,0,Europe
Netherlands,2010,1,0,0,0,0,0,28000,Europe
Netherlands,2012,1,1,0,0,0,0,0,Europe
New Zealand,2000,2,0,0,0,0,0,1000,Oceania
New Zealand,2001,1,0,0,0,0,0,200000,Oceania
New Zealand,2002,2,0,0,301,0,301,500,Oceania
New Zealand,2003,1,2,0,0,0,0,3000,Oceania
New Zealand,2004,2,4,0,5350,0,5350,245000,Oceania
New Zealand,2005,2,0,0,100,400,500,82000,Oceania
New Zealand,2006,1,0,0,1200,0,1200,3000,Oceania
New Zealand,2007,1,0,0,300,0,300,0,Oceania
New Zealand,2010,1,0,2,300000,0,300002,6500000,Oceania
New Zealand,2011,2,182,1545,300000,300,301845,18000000,Oceania
New Zealand,2012,1,3,7,450,0,457,9100,Oceania
New Zealand,2013,1,0,0,0,0,0,1600000,Oceania
Nicaragua,2000,5,9,42,9795,5650,15487,1000,Americas
Nicaragua,2001,2,16,0,212866,0,212866,1000,Americas
Nicaragua,2002,3,2,0,26842,3004,29846,1050,Americas
Nicaragua,2004,2,29,18,5951,0,5969,0,Americas
Nicaragua,2005,2,7,0,7880,5763,13643,0,Americas
Nicaragua,2007,2,198,0,212726,0,212726,0,Americas
Nicaragua,2008,3,30,0,39188,0,39188,0,Americas
Nicaragua,2009,4,8,0,28832,0,28832,0,Americas
Nicaragua,2010,5,87,0,76255,0,76255,0,Americas
Nicaragua,2011,1,17,18,143000,0,143018,0,Americas
Nicaragua,2012,1,9,0,29500,0,29500,0,Americas
Niger,2000,4,192,3,5307,0,5310,0,Africa
Niger,2001,5,577,0,3652625,0,3652625,0,Africa
Niger,2002,3,320,3,4556,0,4559,0,Africa
Niger,2003,2,202,0,31861,0,31861,0,Africa
Niger,2004,3,154,0,20132,0,20132,0,Africa
Niger,2005,2,44,0,3000387,0,3000387,0,Africa
Niger,2006,3,66,0,784,46472,47256,0,Africa
Niger,2007,1,7,10,57264,0,57274,0,Africa
Niger,2008,3,180,0,34805,0,34805,0,Africa
Niger,2009,3,172,0,7983642,0,7983642,0,Africa
Niger,2010,4,108,0,227828,6615,234443,0,Africa
Niger,2011,4,64,0,3015130,28175,3043305,0,Africa
Niger,2012,3,188,0,535826,0,535826,2750,Africa
Nigeria,2000,12,135,0,1755,6300,8055,6705,Africa
Nigeria,2001,8,744,50,86701,5802,92553,3000,Africa
Nigeria,2002,9,315,0,3903,200,4103,0,Africa
Nigeria,2003,1,16,0,210000,0,210000,2570,Africa
Nigeria,2004,9,266,600,31197,0,31797,0,Africa
Nigeria,2005,6,779,4,24873,3000,27877,147,Africa
Nigeria,2006,3,40,0,3000,10000,13000,0,Africa
Nigeria,2007,4,291,0,55000,0,55000,0,Africa
Nigeria,2008,3,178,0,66,0,66,0,Africa
Nigeria,2009,3,1732,0,185255,0,185255,0,Africa
Nigeria,2010,3,549,200,1508500,0,1508700,30000,Africa
Nigeria,2011,6,879,162,51647,500,52309,4500,Africa
Nigeria,2012,3,388,867,7015029,0,7015896,501000,Africa
Norway,2000,1,0,0,600,0,600,0,Europe
Norway,2001,1,0,0,1500,0,1500,0,Europe
Norway,2005,1,0,0,0,0,0,130000,Europe
Norway,2008,1,0,100,0,0,100,0,Europe
Norway,2011,1,4,0,500,0,500,0,Europe
Oman,2002,1,7,33,50,0,83,50000,Asia
Oman,2003,1,30,0,0,0,0,1000,Asia
Oman,2007,1,76,0,20000,0,20000,3900000,Asia
Oman,2010,1,16,0,0,0,0,1000000,Asia
Oman,2011,1,14,200,0,0,200,0,Asia
Pakistan,2000,4,133,0,258,0,258,0,Asia
Pakistan,2001,7,257,291,1319192,500,1319983,246500,Asia
Pakistan,2002,9,210,151,154767,5000,159918,30,Asia
Pakistan,2003,6,529,533,1265767,2500,1268800,0,Asia
Pakistan,2004,4,31,163,10765,2320,13248,0,Asia
Pakistan,2005,11,74204,129090,7523073,5003500,12655663,5230000,Asia
Pakistan,2006,9,513,630,2000,5600,8230,0,Asia
Pakistan,2007,10,911,209,1652502,0,1652711,1947118,Asia
Pakistan,2008,4,249,332,365752,0,366084,113000,Asia
Pakistan,2009,3,102,80,75000,0,75080,0,Asia
Pakistan,2010,7,2186,3018,20394883,0,20397901,9598000,Asia
Pakistan,2011,2,511,755,5401000,0,5401755,2500000,Asia
Pakistan,2012,5,671,2902,5047662,0,5050564,2500000,Asia
Pakistan,2013,2,42,57,0,0,57,0,Asia
Palestine (West Bank),2008,1,0,0,0,0,0,0,Asia
Palestine (West Bank),2010,1,0,0,0,500,500,0,Asia
Palestine (West Bank),2012,1,0,0,1500,0,1500,0,Asia
Palestine (West Bank),2013,1,5,0,12500,0,12500,0,Asia
Panama,2000,1,1,0,0,1000,1000,1300,Americas
Panama,2001,1,0,0,0,775,775,0,Americas
Panama,2002,3,5,0,25173,1500,26673,500,Americas
Panama,2003,3,2,75,2000,340,2415,0,Americas
Panama,2004,3,16,0,22748,0,22748,0,Americas
Panama,2005,1,3,0,7000,0,7000,7000,Americas
Panama,2006,3,11,0,6576,1290,7866,0,Americas
Panama,2007,1,2,0,129,0,129,0,Americas
Panama,2008,2,28,5,23832,0,23837,10000,Americas
Panama,2009,1,0,0,4248,0,4248,0,Americas
Panama,2010,4,15,299,32642,0,32941,0,Americas
Panama,2011,2,0,0,4000,0,4000,0,Americas
Panama,2012,2,6,32,9416,0,9448,0,Americas
Panama,2013,1,0,0,0,0,0,200000,Americas
Papua New Guinea,2000,1,1,0,0,5000,5000,0,Oceania
Papua New Guinea,2001,2,0,1,1395,200,1596,0,Oceania
Papua New Guinea,2002,6,183,81,19778,1000,20859,0,Oceania
Papua New Guinea,2003,2,13,21,600,0,621,0,Oceania
Papua New Guinea,2004,2,0,0,19600,0,19600,0,Oceania
Papua New Guinea,2005,3,2,0,17493,200,17693,0,Oceania
Papua New Guinea,2006,6,16,0,3999,22000,25999,0,Oceania
Papua New Guinea,2007,1,172,0,162140,0,162140,0,Oceania
Papua New Guinea,2008,2,10,0,75300,0,75300,0,Oceania
Papua New Guinea,2009,4,211,0,7391,0,7391,0,Oceania
Papua New Guinea,2011,1,0,0,0,0,0,0,Oceania
Papua New Guinea,2012,2,65,0,200000,0,200000,27000,Oceania
Papua New Guinea,2013,1,0,0,35000,0,35000,0,Oceania
Paraguay,2000,1,8,0,0,0,0,0,Americas
Paraguay,2002,2,0,0,2765,12500,15265,0,Americas
Paraguay,2004,1,0,0,0,0,0,0,Americas
Paraguay,2005,1,0,0,52990,0,52990,0,Americas
Paraguay,2006,1,17,0,100000,0,100000,0,Americas
Paraguay,2007,1,8,0,125000,0,125000,30000,Americas
Paraguay,2008,5,12,0,71612,0,71612,0,Americas
Paraguay,2009,4,8,0,212759,0,212759,820,Americas
Paraguay,2010,2,12,0,13681,0,13681,0,Americas
Paraguay,2011,2,44,0,16264,2000,18264,0,Americas
Paraguay,2012,3,5,100,1495845,0,1495945,6000,Americas
Peru,2000,3,33,0,0,50,50,0,Americas
Peru,2001,7,186,2743,292800,125015,420558,300000,Americas
Peru,2002,5,82,14,119036,0,119050,0,Americas
Peru,2003,3,361,12,1901388,3950,1905350,0,Americas
Peru,2004,4,101,1800006,344967,70,2145043,0,Americas
Peru,2005,2,5,59,2446,0,2505,50,Americas
Peru,2006,3,0,0,18000,325,18325,0,Americas
Peru,2007,3,677,1377,1589240,0,1590617,600000,Americas
Peru,2008,1,40,12,450000,0,450012,0,Americas
Peru,2009,7,577,24709,251177,150,276036,0,Americas
Peru,2010,4,510,54,169303,1000,170357,0,Americas
Peru,2011,6,109,213,837148,1705,839066,0,Americas
Peru,2012,6,299,174,313124,51385,364683,0,Americas
Peru,2013,1,67,0,180734,0,180734,0,Americas
Philippines,2000,13,748,393,6299359,125250,6425002,89758,Asia
Philippines,2001,11,630,480,3524478,100000,3624958,109641,Asia
Philippines,2002,13,322,233,1207991,3000,1211224,17543,Asia
Philippines,2003,10,350,75,604471,83203,687749,42302,Asia
Philippines,2004,13,1950,1321,3253055,8700,3263076,138867,Asia
Philippines,2005,4,39,0,213057,0,213057,2515,Asia
Philippines,2006,20,2984,2703,8610114,0,8612817,347281,Asia
Philippines,2007,16,129,24,2023068,0,2023092,16815,Asia
Philippines,2008,20,959,1015,8404236,54645,8459896,481202,Asia
Philippines,2009,25,1307,900,13351474,110,13352484,962107,Asia
Philippines,2010,15,1113,124096,5457411,0,5581507,335087,Asia
Philippines,2011,36,1989,6703,11723244,0,11729947,730025,Asia
Philippines,2012,22,2415,2879,12492805,35762,12531446,1800220,Asia
Philippines,2013,1,10,0,507769,0,507769,2800,Asia
Poland,2000,1,84,0,0,0,0,0,Europe
Poland,2001,2,297,0,15000,0,15000,700000,Europe
Poland,2002,3,192,0,0,0,0,150,Europe
Poland,2004,1,0,0,600,0,600,0,Europe
Poland,2005,4,193,0,3600,0,3600,0,Europe
Poland,2006,1,0,0,500,0,500,0,Europe
Poland,2007,2,19,0,0,0,0,100000,Europe
Poland,2008,2,84,10,1050,0,1060,50000,Europe
Poland,2009,3,307,82,150,0,232,100000,Europe
Poland,2010,3,219,0,100700,0,100700,3080000,Europe
Poland,2011,1,26,0,0,0,0,0,Europe
Poland,2012,4,198,10,300,0,310,5900,Europe
Poland,2013,1,25,0,0,0,0,0,Europe
Portugal,2000,1,4,10,0,60,70,0,Europe
Portugal,2001,2,6,0,0,200,200,0,Europe
Portugal,2002,1,1,0,0,60,60,0,Europe
Portugal,2003,3,2710,0,150036,0,150036,1730000,Europe
Portugal,2004,2,2,0,0,0,0,1338136,Europe
Portugal,2005,1,15,136,0,0,136,1650000,Europe
Portugal,2006,2,41,0,240,0,240,0,Europe
Portugal,2008,2,2,0,72,38,110,0,Europe
Portugal,2010,3,46,18,600,0,618,1620000,Europe
Puerto Rico,2001,1,2,0,9300,180,9480,146000,Americas
Puerto Rico,2003,2,2,0,2405,100,2505,0,Americas
Puerto Rico,2004,3,2,0,3500,0,3500,100000,Americas
Puerto Rico,2007,1,1,0,0,0,0,0,Americas
Puerto Rico,2011,2,1,0,1500,771,2271,500000,Americas
Puerto Rico,2012,1,0,0,0,0,0,0,Americas
Romania,2000,5,29,100,63000,731,63831,600500,Europe
Romania,2001,3,17,3,14800,0,14803,135000,Europe
Romania,2002,5,19,1,4801,3900,8702,290,Europe
Romania,2003,2,3,0,0,600,600,0,Europe
Romania,2004,6,49,0,30528,0,30528,0,Europe
Romania,2005,9,163,502,55769,800,57071,1313000,Europe
Romania,2006,7,77,202,19581,5000,24783,0,Europe
Romania,2007,6,80,0,4260,0,4260,0,Europe
Romania,2008,3,48,20,11090,0,11110,0,Europe
Romania,2009,3,22,4,0,0,4,0,Europe
Romania,2010,2,78,0,12237,0,12237,0,Europe
Romania,2012,1,86,239,7300,0,7539,0,Europe
Russia,2000,25,284,362,79943,19100,99405,44865,Europe
Russia,2001,11,798,322,393305,400,394027,308300,Europe
Russia,2002,12,631,1262,406914,1620,409796,1010970,Europe
Russia,2003,5,3,5,1000600,1800,1002405,10600,Europe
Russia,2004,8,36,62,12658,1000,13720,62759,Europe
Russia,2005,9,147,16,9045,0,9061,1023668,Europe
Russia,2006,4,0,40,19720,0,19760,187411,Europe
Russia,2007,3,2,12,14000,7500,21512,445752,Europe
Russia,2008,1,13,100,5135,0,5235,0,Europe
Russia,2010,8,55844,1007,53464,1200,55671,3666000,Europe
Russia,2011,3,1,14,14169,0,14183,24015,Europe
Russia,2012,8,415,5850,37397,5752,48999,1757000,Europe
Rwanda,2000,1,10,0,164,0,164,0,Africa
Rwanda,2001,2,12,0,3000,0,3000,0,Africa
Rwanda,2002,3,197,108,22171,0,22279,0,Africa
Rwanda,2003,2,0,16,1000000,7000,1007016,0,Africa
Rwanda,2004,1,4,0,540,0,540,0,Africa
Rwanda,2006,2,59,0,2300,0,2300,0,Africa
Rwanda,2007,2,30,0,4500,0,4500,9,Africa
Rwanda,2008,2,36,694,11295,0,11989,0,Africa
Rwanda,2010,2,21,17,0,5920,5937,0,Africa
Rwanda,2011,1,14,20,3588,0,3608,0,Africa
Rwanda,2012,1,5,0,11160,0,11160,0,Africa
Samoa,2001,1,0,0,0,0,0,1500,Oceania
Samoa,2004,1,1,0,0,0,0,0,Oceania
Samoa,2005,1,9,0,0,0,0,0,Oceania
Samoa,2009,1,143,310,5275,0,5585,150000,Oceania
Samoa,2012,1,12,0,12703,0,12703,133000,Oceania
Saudi Arabia,2000,2,133,0,497,0,497,0,Asia
Saudi Arabia,2001,1,35,0,74,0,74,0,Asia
Saudi Arabia,2002,1,19,0,0,0,0,0,Asia
Saudi Arabia,2003,2,12,50,13000,0,13050,0,Asia
Saudi Arabia,2004,1,5,30,400,0,430,0,Asia
Saudi Arabia,2005,2,63,17,50,0,67,0,Asia
Saudi Arabia,2009,1,161,0,0,10000,10000,900000,Asia
Saudi Arabia,2010,2,24,0,85,0,85,0,Asia
Saudi Arabia,2011,1,11,0,0,0,0,300000,Asia
Saudi Arabia,2012,1,19,0,0,0,0,0,Asia
Saudi Arabia,2013,1,20,0,0,0,0,0,Asia
Senegal,2000,1,0,0,0,0,0,0,Africa
Senegal,2002,4,46,0,463181,0,463181,40979,Africa
Senegal,2003,1,8,0,1277,6492,7769,0,Africa
Senegal,2004,3,8,0,861,1000,1861,0,Africa
Senegal,2005,2,303,0,73022,0,73022,0,Africa
Senegal,2007,2,24,0,8125,0,8125,0,Africa
Senegal,2008,1,1,0,23600,0,23600,0,Africa
Senegal,2009,1,6,0,264000,0,264000,0,Africa
Senegal,2010,2,2,63,102453,0,102516,0,Africa
Senegal,2011,2,0,6,855214,0,855220,0,Africa
Senegal,2012,1,19,0,57000,0,57000,10000,Africa
Serbia,2007,2,0,0,12370,0,12370,0,Europe
Serbia,2009,2,0,500,3210,0,3710,0,Europe
Serbia,2010,6,9,120,30340,1470,31930,132260,Europe
Serbia,2012,3,25,0,88234,0,88234,0,Europe
Serbia,2013,1,0,0,330,0,330,0,Europe
Serbia Montenegro,2000,4,3,70,6000,12,6082,0,Europe
Serbia Montenegro,2001,1,0,0,170,0,170,0,Europe
Serbia Montenegro,2002,2,1,100,2400,0,2500,0,Europe
Serbia Montenegro,2005,3,5,0,1945,1845,3790,0,Europe
Serbia Montenegro,2006,2,0,0,36200,0,36200,0,Europe
Seychelles,2002,1,0,0,6800,0,6800,0,Africa
Seychelles,2004,1,3,0,4760,70,4830,30000,Africa
Seychelles,2005,1,0,0,5461,0,5461,0,Africa
Seychelles,2013,1,0,0,1200,0,1200,9300,Africa
Sierra Leone,2000,1,38,0,0,0,0,0,Africa
Sierra Leone,2001,1,12,0,3,0,3,0,Africa
Sierra Leone,2003,1,10,0,90,0,90,0,Africa
Sierra Leone,2004,2,66,0,633,0,633,0,Africa
Sierra Leone,2005,1,20,0,15000,0,15000,0,Africa
Sierra Leone,2007,1,0,0,4500,0,4500,0,Africa
Sierra Leone,2008,1,170,0,1746,0,1746,0,Africa
Sierra Leone,2009,1,103,15,1455,0,1470,0,Africa
Sierra Leone,2010,2,16,5,234,0,239,0,Africa
Sierra Leone,2011,1,21,0,0,0,0,0,Africa
Sierra Leone,2012,1,300,0,23009,0,23009,0,Africa
Sierra Leone,2013,1,0,0,0,2257,2257,0,Africa
Singapore,2000,1,2,0,2022,0,2022,0,Asia
Singapore,2002,1,33,0,205,0,205,0,Asia
Slovakia,2000,1,6,0,0,0,0,0,Europe
Slovakia,2001,1,1,0,0,0,0,6000,Europe
Slovakia,2002,1,0,0,0,0,0,3000,Europe
Slovakia,2003,1,0,0,0,0,0,150000,Europe
Slovakia,2004,2,3,24,10530,0,10554,383300,Europe
Slovakia,2005,2,1,0,0,0,0,0,Europe
Slovakia,2006,2,1,0,100,0,100,0,Europe
Slovakia,2007,1,1,89,0,0,89,0,Europe
Slovakia,2010,3,126,0,850,0,850,25000,Europe
Slovakia,2012,1,5,0,0,0,0,0,Europe
Slovenia,2003,1,289,0,0,0,0,80000,Europe
Slovenia,2004,1,1,5,600,0,605,10000,Europe
Slovenia,2005,1,0,0,0,0,0,5000,Europe
Slovenia,2007,2,6,0,0,1050,1050,392000,Europe
Slovenia,2012,1,0,0,12000,0,12000,265000,Europe
Solomon Is,2002,1,0,10,0,1100,1110,0,Oceania
Solomon Is,2003,2,0,0,275,150,425,0,Oceania
Solomon Is,2007,1,52,9,2375,0,2384,0,Oceania
Solomon Is,2008,1,0,0,0,0,0,0,Oceania
Solomon Is,2009,1,21,0,7000,0,7000,0,Oceania
Solomon Is,2010,3,2,2,17141,590,17733,0,Oceania
Solomon Is,2011,1,0,0,0,0,0,0,Oceania
Solomon Is,2012,1,0,0,4836,0,4836,0,Oceania
Solomon Is,2013,1,10,0,3329,0,3329,0,Oceania
Somalia,2000,7,688,0,155990,220000,375990,0,Africa
Somalia,2001,2,33,0,6611,0,6611,0,Africa
Somalia,2002,3,93,0,1191,0,1191,0,Africa
Somalia,2003,2,1,0,300,0,300,0,Africa
Somalia,2004,3,298,283,304800,1500,306583,100000,Africa
Somalia,2005,5,27,20,5199,2500,7719,20,Africa
Somalia,2006,10,246,0,492376,0,492376,0,Africa
Somalia,2007,3,1158,12,43687,2000,45699,0,Africa
Somalia,2008,3,13,0,3352663,0,3352663,0,Africa
Somalia,2009,1,0,0,1750,0,1750,0,Africa
Somalia,2010,3,11,0,4016000,200,4016200,0,Africa
Somalia,2011,1,0,0,2800,0,2800,0,Africa
Somalia,2012,3,31,0,3012200,20000,3032200,0,Africa
South Africa,2000,6,275,100,90107,650,90857,170000,Africa
South Africa,2001,6,50,52,42656,600,43308,0,Africa
South Africa,2002,10,127,566,117002,1000,118568,14041,Africa
South Africa,2003,2,1,0,500,600,1100,0,Africa
South Africa,2004,3,5,0,15000174,15000,15015174,0,Africa
South Africa,2005,1,2,58,0,0,58,20000,Africa
South Africa,2006,2,12,0,7160,0,7160,216000,Africa
South Africa,2007,3,48,0,38000,1600,39600,0,Africa
South Africa,2008,4,115,101,16752,3500,20353,431264,Africa
South Africa,2009,4,33,0,20300,0,20300,15000,Africa
South Africa,2010,1,40,0,6000,0,6000,0,Africa
South Africa,2011,3,46,217,202606,3500,206323,221000,Africa
South Africa,2012,2,13,0,126350,0,126350,200000,Africa
South Africa,2013,1,3,0,2870,0,2870,0,Africa
South Sudan,2012,2,47,0,157000,0,157000,0,Africa
Spain,2000,5,38,2,1000,0,1002,75000,Europe
Spain,2001,2,12,0,751,0,751,72000,Europe
Spain,2002,2,6,50,1,0,51,87000,Europe
Spain,2003,2,15095,0,200,0,200,880000,Europe
Spain,2004,3,29,100,1600,0,1700,17285,Europe
Spain,2005,2,20,1,0,0,1,2050000,Europe
Spain,2006,3,25,0,0,0,0,659000,Europe
Spain,2007,4,6,0,4430,0,4430,400000,Europe
Spain,2009,2,20,0,0,0,0,1900000,Europe
Spain,2010,2,5,0,30,0,30,340000,Europe
Spain,2011,2,11,300,2400,15000,17700,200000,Europe
Spain,2012,2,14,41,600,0,641,395000,Europe
Spain,2013,1,0,0,600,0,600,0,Europe
Sri Lanka,2000,4,12,0,775113,0,775113,3000,Asia
Sri Lanka,2001,2,0,0,1000000,160,1000160,0,Asia
Sri Lanka,2002,1,2,0,500000,0,500000,0,Asia
Sri Lanka,2003,1,235,0,695000,0,695000,29000,Asia
Sri Lanka,2004,3,35493,23176,731130,480000,1234306,1316500,Asia
Sri Lanka,2005,1,6,0,145000,0,145000,0,Asia
Sri Lanka,2006,1,25,2,333000,0,333002,3000,Asia
Sri Lanka,2007,3,33,0,406000,0,406000,50,Asia
Sri Lanka,2008,4,57,0,826905,0,826905,0,Asia
Sri Lanka,2009,4,349,0,355007,60000,415007,0,Asia
Sri Lanka,2010,2,27,10,239183,0,239193,105000,Asia
Sri Lanka,2011,5,254,92,294943,1060273,1355308,500000,Asia
Sri Lanka,2012,3,53,21,2247000,69000,2316021,58200,Asia
Sri Lanka,2013,2,110,15,73946,0,73961,0,Asia
St Lucia,2004,1,0,0,0,0,0,500,Americas
St Lucia,2007,2,1,0,0,0,0,40000,Americas
St Lucia,2010,3,10,0,3000,0,3000,500,Americas
St Vincent and The Grenadines,2002,1,4,0,0,0,0,11000,Americas
St Vincent and The Grenadines,2004,1,0,4,1000,0,1004,5000,Americas
St Vincent and The Grenadines,2005,1,0,0,530,0,530,0,Americas
St Vincent and The Grenadines,2010,1,0,0,6000,100,6100,25000,Americas
St Vincent and The Grenadines,2011,1,0,0,275,0,275,0,Americas
Sudan,2000,1,186,0,2363,0,2363,0,Africa
Sudan,2001,1,3,0,97000,0,97000,2000,Africa
Sudan,2002,4,82,0,101281,0,101281,0,Africa
Sudan,2003,2,47,56,325178,0,325234,184000,Africa
Sudan,2004,3,98,0,8114,0,8114,0,Africa
Sudan,2005,5,655,0,163454,4780,168234,0,Africa
Sudan,2006,8,1169,0,189769,6000,195769,0,Africa
Sudan,2007,4,734,335,372639,200000,572974,300000,Africa
Sudan,2008,5,32,0,93003,0,93003,0,Africa
Sudan,2009,2,20,0,4411455,0,4411455,0,Africa
Sudan,2010,2,36,12,16350,10000,26362,0,Africa
Sudan,2011,1,20,30,0,0,30,0,Africa
Sudan,2012,3,206,135,3335678,0,3335813,0,Africa
Swaziland,2000,2,32,0,273449,0,273449,50,Africa
Swaziland,2001,1,0,0,970000,0,970000,0,Africa
Swaziland,2005,1,0,0,890,260,1150,0,Africa
Swaziland,2006,1,1,0,6535,0,6535,0,Africa
Swaziland,2007,2,2,0,411500,0,411500,0,Africa
Swaziland,2008,1,0,0,2500,0,2500,0,Africa
Sweden,2002,3,1,0,350,0,350,0,Europe
Sweden,2005,2,7,0,0,0,0,2800000,Europe
Switzerland,2000,1,16,0,1500,0,1500,330000,Europe
Switzerland,2001,1,0,0,0,0,0,0,Europe
Switzerland,2002,4,5,2,282,0,284,180000,Europe
Switzerland,2003,2,1039,7,0,0,7,285000,Europe
Switzerland,2005,2,6,0,2500,0,2500,2100000,Europe
Switzerland,2006,2,1,0,3000,0,3000,0,Europe
Switzerland,2007,3,1,1,100,0,101,450000,Europe
Switzerland,2009,1,0,0,0,0,0,1000000,Europe
Switzerland,2010,2,0,0,0,0,0,14000,Europe
Switzerland,2011,1,0,3,0,0,3,0,Europe
Switzerland,2012,2,11,0,0,0,0,0,Europe
Switzerland,2013,1,0,84,0,0,84,250000,Europe
Syrian Arab Rep,2001,1,27,172,0,0,172,0,Asia
Syrian Arab Rep,2002,1,80,23,0,0,23,0,Asia
Syrian Arab Rep,2004,1,5,180,0,0,180,0,Asia
Syrian Arab Rep,2006,1,6,0,0,0,0,0,Asia
Syrian Arab Rep,2008,1,0,0,1300000,0,1300000,0,Asia
Taiwan (China),2000,2,103,102,0,2000,2102,285000,Asia
Taiwan (China),2001,5,195,339,650000,2000,652339,1047000,Asia
Taiwan (China),2002,4,49,200,609,0,809,25050,Asia
Taiwan (China),2003,1,3,0,0,0,0,0,Asia
Taiwan (China),2004,5,79,108,8765,0,8873,407710,Asia
Taiwan (China),2005,5,33,139,4200,0,4339,301000,Asia
Taiwan (China),2006,4,8,42,1100,0,1142,116130,Asia
Taiwan (China),2007,2,18,79,1000,1800,2879,60000,Asia
Taiwan (China),2008,5,54,88,0,0,88,142400,Asia
Taiwan (China),2009,1,630,46,2307477,0,2307523,250000,Asia
Taiwan (China),2010,3,34,196,0,0,196,1073100,Asia
Taiwan (China),2012,3,20,0,35000,0,35000,52200,Asia
Taiwan (China),2013,1,4,19,1500,0,1519,1100,Asia
Tajikistan,2000,2,0,0,3006000,0,3006000,57000,Asia
Tajikistan,2001,3,1,15,3020,150,3185,834,Asia
Tajikistan,2002,6,35,63,2248,3490,5801,2836,Asia
Tajikistan,2003,4,7,0,7412,780,8192,61000,Asia
Tajikistan,2004,2,0,0,400180,0,400180,12000,Asia
Tajikistan,2005,3,24,3,6327,735,7065,50000,Asia
Tajikistan,2006,3,25,24,29131,0,29155,22000,Asia
Tajikistan,2007,4,49,3,24184,125,24312,0,Asia
Tajikistan,2008,2,0,0,2800000,0,2800000,840000,Asia
Tajikistan,2009,1,21,0,15000,0,15000,1000,Asia
Tajikistan,2010,4,96,300,15484,1134,16918,205500,Asia
Tajikistan,2011,2,0,0,2130,0,2130,0,Asia
Tajikistan,2012,3,3,0,8087,0,8087,760,Asia
Tajikistan,2013,1,0,0,2500,0,2500,0,Asia
Tanzania Uni Rep,2000,6,74,23,1648,1835,3506,0,Africa
Tanzania Uni Rep,2001,5,43,0,515,1050,1565,0,Africa
Tanzania Uni Rep,2002,3,20,0,1349,2000,3349,0,Africa
Tanzania Uni Rep,2003,2,0,0,1902000,0,1902000,0,Africa
Tanzania Uni Rep,2004,2,10,0,254000,0,254000,0,Africa
Tanzania Uni Rep,2005,3,9,0,16124,0,16124,0,Africa
Tanzania Uni Rep,2006,8,70,28,3701410,21500,3722938,0,Africa
Tanzania Uni Rep,2007,2,119,0,284,0,284,0,Africa
Tanzania Uni Rep,2008,4,73,22,8170,1942,10134,0,Africa
Tanzania Uni Rep,2009,4,50,0,51205,0,51205,0,Africa
Tanzania Uni Rep,2011,4,37,200,1059000,6776,1065976,0,Africa
Tanzania Uni Rep,2012,1,10,0,0,0,0,0,Africa
Thailand,2000,6,198,570,3366396,0,3366966,109056,Asia
Thailand,2001,7,222,139,465660,4730,470529,28500,Asia
Thailand,2002,7,192,162,8317865,36104,8354131,40127,Asia
Thailand,2003,5,16,0,112704,0,112704,26400,Asia
Thailand,2004,8,8389,8467,574658,50,583175,1175000,Asia
Thailand,2005,6,86,40,822770,0,822810,658246,Asia
Thailand,2006,3,280,0,2557308,0,2557308,34940,Asia
Thailand,2007,5,53,0,183000,0,183000,1500,Asia
Thailand,2008,6,39,0,11572157,1000,11573157,27844,Asia
Thailand,2009,1,15,0,200000,0,200000,0,Asia
Thailand,2010,3,260,0,15454135,0,15454135,332000,Asia
Thailand,2011,6,923,16,11253838,0,11253854,40317000,Asia
Thailand,2012,1,0,0,235545,0,235545,0,Asia
Togo,2001,2,235,0,1567,0,1567,0,Africa
Togo,2002,1,95,0,494,0,494,0,Africa
Togo,2003,1,40,0,790,0,790,0,Africa
Togo,2006,1,0,0,2000,0,2000,0,Africa
Togo,2007,1,41,77,127880,13374,141331,0,Africa
Togo,2008,2,12,79,45421,0,45500,0,Africa
Togo,2009,1,0,0,0,0,0,0,Africa
Togo,2010,3,82,0,111786,0,111786,0,Africa
Tonga,2001,1,0,0,16500,0,16500,51300,Oceania
Tonga,2004,1,0,0,0,0,0,0,Oceania
Tonga,2009,1,9,7,500,0,507,9500,Oceania
Tonga,2011,1,0,0,0,0,0,3000,Oceania
Trinidad and Tobago,2004,2,3,0,1760,0,1760,1000,Americas
Trinidad and Tobago,2005,1,0,0,0,0,0,0,Americas
Trinidad and Tobago,2010,1,0,0,0,0,0,0,Americas
Tunisia,2003,2,12,0,27000,0,27000,0,Africa
Tunisia,2007,2,16,0,6500,0,6500,0,Africa
Tunisia,2009,1,17,8,0,0,8,0,Africa
Turkey,2000,6,16,380,25000,350,25730,41000,Asia
Turkey,2001,7,50,176,3555,0,3731,25000,Asia
Turkey,2002,4,90,327,225000,30000,255327,95000,Asia
Turkey,2003,5,186,692,245240,45000,290932,135000,Asia
Turkey,2004,11,89,217,38443,50000,88660,0,Asia
Turkey,2005,7,41,253,5950,0,6203,0,Asia
Turkey,2006,3,79,15,63222,0,63237,317000,Asia
Turkey,2007,4,19,0,3150,36,3186,0,Asia
Turkey,2008,1,2,0,0,300,300,0,Asia
Turkey,2009,4,62,31,35106,0,35137,550000,Asia
Turkey,2010,2,64,106,3500,200,3806,0,Asia
Turkey,2011,4,655,4306,6786,32075,43167,1744000,Asia
Turkey,2012,1,13,0,0,0,0,0,Asia
Turkmenistan,2000,1,11,0,0,0,0,0,Asia
Tuvalu,2011,1,0,0,0,0,0,0,Oceania
Uganda,2000,5,259,5,723,10000,10728,0,Africa
Uganda,2001,4,26,10,3865,300,4175,0,Africa
Uganda,2002,4,96,0,655760,200,655960,0,Africa
Uganda,2003,3,60,0,942,1500,2442,0,Africa
Uganda,2004,3,3,0,10053,20000,30053,0,Africa
Uganda,2005,3,21,0,600726,0,600726,0,Africa
Uganda,2006,6,206,0,11382,0,11382,0,Africa
Uganda,2007,4,165,0,444007,282975,726982,71,Africa
Uganda,2008,3,77,40,1130388,0,1130428,0,Africa
Uganda,2009,2,17,0,544,0,544,0,Africa
Uganda,2010,3,436,10,681975,0,681985,0,Africa
Uganda,2011,2,50,47,63075,0,63122,0,Africa
Uganda,2012,5,174,180,20864,3368,24412,0,Africa
Uganda,2013,2,17,216,20000,0,20216,3100,Africa
Ukraine,2000,4,10,710,47400,0,48110,205000,Europe
Ukraine,2001,1,9,0,300000,0,300000,15000,Europe
Ukraine,2003,1,0,0,600,0,600,0,Europe
Ukraine,2005,2,801,9600,58340,0,67940,0,Europe
Ukraine,2006,2,2,0,5000,0,5000,23855,Europe
Ukraine,2007,2,0,17,6268,1267,7552,100000,Europe
Ukraine,2008,2,43,0,224725,0,224725,1000000,Europe
Ukraine,2009,1,27,0,0,0,0,0,Europe
Ukraine,2010,1,6,59,40000,0,40059,1900,Europe
Ukraine,2012,3,195,3026,85000,0,88026,1690000,Europe
United Kingdom,2000,5,16,4,21540,0,21544,7418150,Europe
United Kingdom,2001,3,11,0,270,0,270,0,Europe
United Kingdom,2002,6,15,0,754,0,754,400050,Europe
United Kingdom,2003,1,301,0,0,0,0,0,Europe
United Kingdom,2004,1,0,8,1000,0,1008,96000,Europe
United Kingdom,2005,4,11,0,3000,0,3000,700000,Europe
United Kingdom,2007,5,27,1,344700,30000,374701,9708000,Europe
United Kingdom,2008,3,8,0,3300,0,3300,3000,Europe
United Kingdom,2009,3,8,47,4080,0,4127,484000,Europe
United Kingdom,2010,2,0,0,0,0,0,500,Europe
United Kingdom,2012,5,8,0,3785,0,3785,2946000,Europe
United States,2000,31,162,360,81564,6374,88298,5301600,Americas
United States,2001,28,153,641,128218,75868,204727,8335800,Americas
United States,2002,32,443,413,171053,3409,174875,10816100,Americas
United States,2003,23,210,566,258195,16101,274862,18942600,Americas
United States,2004,23,219,62,5099724,1035,5100821,55692000,Americas
United States,2005,16,1973,47,848415,1542,850004,159060330,Americas
United States,2006,29,326,296,82974,267,83537,6422360,Americas
United States,2007,23,333,521,666470,1127,668118,9663000,Americas
United States,2008,22,303,768,13390150,300,13391218,57762000,Americas
United States,2009,17,145,247,9750,1326,11323,12256000,Americas
United States,2010,14,98,171,12300,0,12471,9162500,Americas
United States,2011,23,809,3598,395700,32100,431398,59433000,Americas
United States,2012,25,318,437,91409,1305,93151,98469000,Americas
United States,2013,5,92,600,170084,1920,172604,5700000,Americas
Uruguay,2000,3,7,0,5400,100,5500,0,Americas
Uruguay,2001,1,0,0,5000,0,5000,0,Americas
Uruguay,2002,2,2,0,1300,2700,4000,25000,Americas
Uruguay,2003,1,0,0,200,0,200,0,Americas
Uruguay,2004,1,0,0,2000,0,2000,0,Americas
Uruguay,2005,1,7,12,0,0,12,0,Americas
Uruguay,2007,3,2,0,110000,10000,120000,45000,Americas
Uruguay,2009,1,12,0,22000,0,22000,0,Americas
Uruguay,2010,1,4,0,0,0,0,0,Americas
Uzbekistan,2000,1,0,0,600000,0,600000,50000,Asia
Uzbekistan,2005,1,0,0,1500,0,1500,0,Asia
Uzbekistan,2011,1,13,0,86,0,86,0,Asia
Vanuatu,2001,3,2,0,5005,295,5300,0,Oceania
Vanuatu,2002,3,0,4,4000,0,4004,0,Oceania
Vanuatu,2004,1,2,8,54000,0,54008,0,Oceania
Vanuatu,2005,1,0,0,5000,0,5000,0,Oceania
Vanuatu,2006,1,0,0,0,0,0,0,Oceania
Vanuatu,2008,1,0,0,9000,0,9000,0,Oceania
Vanuatu,2009,2,0,0,1350,0,1350,0,Oceania
Vanuatu,2011,2,0,0,0,0,0,0,Oceania
Venezuela,2000,2,15,4,27000,0,27004,0,Americas
Venezuela,2002,1,4,0,55376,0,55376,3000,Americas
Venezuela,2003,2,1,0,450,200,650,0,Americas
Venezuela,2004,2,40,5,1645,4080,5730,0,Americas
Venezuela,2005,4,97,147,44000,1650,45797,51000,Americas
Venezuela,2006,1,0,0,95,40,135,0,Americas
Venezuela,2008,1,8,0,1500,0,1500,0,Americas
Venezuela,2009,1,0,0,0,0,0,0,Americas
Venezuela,2010,3,49,0,94918,0,94918,170000,Americas
Venezuela,2011,3,17,0,1668,2000,3668,16000,Americas
Venezuela,2012,1,0,0,11000,0,11000,93000,Americas
Viet Nam,2000,11,592,215,5027505,11860,5039580,291035,Asia
Viet Nam,2001,7,392,95,1785895,23100,1809090,171900,Asia
Viet Nam,2002,7,152,116,2733558,0,2733674,284200,Asia
Viet Nam,2003,5,143,81,402888,18880,421849,105000,Asia
Viet Nam,2004,7,231,23,535951,0,535974,38000,Asia
Viet Nam,2005,11,324,31,851900,18205,870136,346370,Asia
Viet Nam,2006,11,579,2010,2994720,352680,3349410,1099000,Asia
Viet Nam,2007,7,353,322,1599755,47525,1647602,981000,Asia
Viet Nam,2008,10,411,163,776330,12660,789153,673500,Asia
Viet Nam,2009,6,356,1006,3607820,108635,3717461,1065200,Asia
Viet Nam,2010,7,221,103,1522710,1620,1524433,704700,Asia
Viet Nam,2011,5,138,77,1361570,0,1361647,219002,Asia
Viet Nam,2012,4,72,147,59320,297045,356512,372800,Asia
Wallis and Futuna Is,2012,1,0,2,1250,0,1252,0,Oceania
Yemen,2000,1,32,0,289,0,289,0,Asia
Yemen,2001,3,63,0,0,0,0,0,Asia
Yemen,2002,4,53,0,260,440,700,0,Asia
Yemen,2003,1,15,0,0,0,0,0,Asia
Yemen,2005,4,87,17,394,500,911,0,Asia
Yemen,2006,2,30,20,0,2300,2320,0,Asia
Yemen,2007,4,99,33,2600,0,2633,0,Asia
Yemen,2008,1,90,64,25000,0,25064,400000,Asia
Yemen,2009,1,11,0,0,0,0,0,Asia
Yemen,2010,2,22,2,0,1000,1002,0,Asia
Zaire/Congo Dem Rep,2000,2,26,0,63,0,63,0,Africa
Zaire/Congo Dem Rep,2001,12,900,26,24094,0,24120,0,Africa
Zaire/Congo Dem Rep,2002,11,2742,440,541875,110000,652315,9000,Africa
Zaire/Congo Dem Rep,2003,7,815,2573,20401,21481,44455,0,Africa
Zaire/Congo Dem Rep,2004,5,706,0,46220,0,46220,0,Africa
Zaire/Congo Dem Rep,2005,4,109,3,4872,5386,10261,0,Africa
Zaire/Congo Dem Rep,2006,11,155,66,87356,3600,91022,0,Africa
Zaire/Congo Dem Rep,2007,3,204,100,1919,0,2019,0,Africa
Zaire/Congo Dem Rep,2008,3,36,10,17355,500,17865,7000,Africa
Zaire/Congo Dem Rep,2009,6,209,0,20909,125,21034,0,Africa
Zaire/Congo Dem Rep,2010,6,110,7,73042,5730,78779,0,Africa
Zaire/Congo Dem Rep,2011,4,636,0,34757,2000,36757,0,Africa
Zaire/Congo Dem Rep,2012,5,609,33,27118,1010,28161,0,Africa
Zambia,2000,3,163,0,13224,0,13224,0,Africa
Zambia,2001,2,16,0,618325,0,618325,0,Africa
Zambia,2003,3,183,0,3835,11000,14835,0,Africa
Zambia,2004,1,2,13,196385,0,196398,0,Africa
Zambia,2005,3,21,0,1211615,0,1211615,0,Africa
Zambia,2006,1,5,0,105,0,105,0,Africa
Zambia,2007,4,19,0,1553636,0,1553636,0,Africa
Zambia,2008,2,177,0,23312,0,23312,0,Africa
Zambia,2009,2,118,0,620012,0,620012,0,Africa
Zambia,2010,2,9,0,1200,150,1350,0,Africa
Zambia,2011,1,0,0,1375,0,1375,0,Africa
Zambia,2012,1,2,0,153,0,153,0,Africa
Zimbabwe,2000,4,182,0,202812,66000,268812,72900,Africa
Zimbabwe,2001,2,13,0,6030000,0,6030000,3600,Africa
Zimbabwe,2002,2,4,0,452,0,452,0,Africa
Zimbabwe,2003,3,50,0,18750,0,18750,200000,Africa
Zimbabwe,2005,2,87,0,1183,0,1183,0,Africa
Zimbabwe,2007,5,94,0,2127000,0,2127000,1200,Africa
Zimbabwe,2008,1,4276,0,98349,0,98349,0,Africa
Zimbabwe,2009,2,55,0,1346,0,1346,0,Africa
Zimbabwe,2010,4,8,0,1668696,0,1668696,0,Africa
Zimbabwe,2011,2,45,0,1140,0,1140,0,Africa
Zimbabwe,2013,1,125,0,9700,0,9700,0,Africa
